аақ[A]-SG-NOM	аақ
аақта[V]-IMP.2SG	аақта
аақта[V]-NR2[N]-SG-NOM	аақташ
аал[N]-SG-NOM	аал
аал[N]-VR2[V]-IMP.2SG	аала
аала[V]-IMP.2SG	аала
аар[A]-SG-NOM	аар
аара[ADV]	аара
аара[PSTP]	аара
аара-пеере[ADV]	аара-пеере
аары[N]-SG-NOM	аары
аас[N]-ATTR1[A]-SG-NOM	аастыг
аас[N]-SG-NOM	аас
аас[V]-IMP.2SG	аас
аба[N]-ATTR1[A]-SG-NOM	абалыг
аба[N]-SG-NOM	аба
аба[N]-VR1[V]-IMP.2SG	абала
аба[N]-VR6[V]-ADJR3[A]-SG-NOM	абаққай
аба[N]-VR6[V]-IMP.2SG	абақ
абақай[N]-ADVR[ADV]	абақайын
абақай[N]-SG-NOM	абақай
абаққай[A]-SG-NOM	абаққай
абаққай[N]-ADVR[ADV]	абаққайын
абаққай[N]-SG-NOM	абаққай
абаққай[N]-VR1[V]-IMP.2SG	абаққайла
абыр[N]-ATTR1[A]-SG-NOM	абырлыг
абыр[N]-SG-NOM	абыр
абыр[N]-VR1[V]-IMP.2SG	абырла
абыр[N]-VR2[V]-IMP.2SG	абыра
абыртқа[N]-SG-NOM	абыртқа
абыт[V]-IMP.2SG	абыт
аг[N]-SG-NOM	аг
аг[N]-VR2[V]-IMP.2SG	аға
аг[N]-VR3[V]-IMP.2SG	ағар
аг[N]-VR7[V]-IMP.2SG	ағар
ағаш[N]-SG-NOM	ағаш
ағаш[N]-VR1[V]-IMP.2SG	ағашта
ағры[V]-IMP.2SG	ағры
ағры[V]-NR1[N]-ATTR1[A]-SG-NOM	ағрығлыг
ағры[V]-NR1[N]-ATTR1[A]-SG-NOM	ағрықынныг
ағый[N]-VR2[V]-IMP.2SG	ағыйа
ада[N]-ADVR[ADV]	адан
ада[N]-ATTR1[A]-SG-NOM	адалыг
ада[N]-SG-NOM	ада
ада[N]-VR1[V]-IMP.2SG	адала
ада[N]-VR2[V]-ADJR5[A]-SG-NOM	адаан
ада[N]-VR2[V]-IMP.2SG	адаа
ада[N]-VR3[V]-IMP.2SG	адар
ада[N]-VR6[V]-IMP.2SG	адақ
адай[N]-ADVR[ADV]	адайын
адай[N]-SG-NOM	адай
адаңма[ADV]	адаңма
ада-эне[N]-SG-NOM	ада-эне
адылға[N]-ADVR[ADV]	адылған
ажыг[N]-SG-NOM	ажыг
ажыг[N]-VR2[V]-IMP.2SG	ажыға
ажыл[V]-IMP.2SG	ажыл
ажыла[V]-IMP.2SG	ажыла
ажын[V]-IMP.2SG	ажын
ажыр[V]-IMP.2SG	ажыр
ажыра[PSTP]	ажыра
азай[N]-ATTR1[A]-SG-NOM	азайлыг
азай[N]-SG-NOM	азай
азайлыг[N]-SG-NOM	азайлыг
азақ[N]-ADVR[ADV]	азағын
азақ[N]-ATTR1[A]-SG-NOM	азақтыг
азақ[N]-SG-NOM	азақ
азақ[N]-VR1[V]-IMP.2SG	азақта
азақ[N]-VR2[V]-IMP.2SG	азаға
азыг[N]-SG-NOM	азыг
азыг[N]-VR2[V]-IMP.2SG	азыға
азық[N]-SG-NOM	азық
азық[N]-VR1[V]-IMP.2SG	азықта
азық[N]-VR2[V]-IMP.2SG	азыға
азыл[V]-IMP.2SG	азыл
азыра[V]-ADJR5[A]-SG-NOM	азыран
азыра[V]-IMP.2SG	азыра
азыра[V]-NR12[N]-SG-NOM	азыраба
азыра[V]-NR6[N]-SG-NOM	азырат
ай[A]-SG-NOM	ай
ай[N]-ATTR1[A]-SG-NOM	айлыг
ай[N]-SG-NOM	ай
ай[N]-VR1[V]-ADJR5[A]-SG-NOM	айлан
ай[N]-VR1[V]-IMP.2SG	айла
ай[N]-VR2[V]-IMP.2SG	айа
айа[N]-ATTR2[A]-SG-NOM	айағы
айа[N]-SG-NOM	айа
айа[N]-VR1[V]-ADJR5[A]-SG-NOM	айлан
айа[N]-VR1[V]-IMP.2SG	айла
айа[N]-VR6[V]-ADJR5[A]-SG-NOM	айағын
айа[N]-VR6[V]-IMP.2SG	айақ
айа[V]-IMP.2SG	айа
айа[V]-NR12[N]-ADVR[ADV]	айабан
айа[V]-NR12[N]-SG-NOM	айаба
айа[V]-NR1[N]-ADVR[ADV]	айағын
айа[V]-NR1[N]-ADVR[ADV]	айақынын
айа[V]-NR1[N]-SG-NOM	айаг
айа[V]-NR1[N]-SG-NOM	айақын
айа[V]-NR3[N]-ADVR[ADV]	айағын
айа[V]-NR3[N]-SG-NOM	айағы
айа[V]-NR5[N]-ADVR[ADV]	айағын
айа[V]-NR5[N]-SG-NOM	айақ
айақ[N]-ADVR[ADV]	айағын
айақ[N]-SG-NOM	айақ
айақ[N]-VR1[V]-IMP.2SG	айақта
айақ[N]-VR2[V]-ADJR5[A]-SG-NOM	айған
айақ[N]-VR2[V]-IMP.2SG	айға
ай-арыг[PN]-SG-NOM	ай-арыг
айас-арыг[PN]-SG-NOM	айас-арыг
айас-кӧӧк[PN]-SG-NOM	айас-кӧӧк
айас-қан[PN]-SG-NOM	айас-қан
айбын[ADV]	айбын
айғыр[N]-SG-NOM	айғыр
айдаң-арыг[PN]-SG-NOM	айдаң-арыг
ай-қан[PN]-SG-NOM	ай-қан
ай-қара-қан[PN]-SG-NOM	ай-қара-қан
ай-қара-қаң[PN]-SG-NOM	ай-қара-қаң
айлан[V]-ADJR2[A]-SG-NOM	айланчы
айлан[V]-IMP.2SG	айлан
айлан[V]-NR2[N]-SG-NOM	айланыш
айлан[V]-NR7[N]-SG-NOM	айланым
аймақ[N]-SG-NOM	аймақ
ай-маңыс[PN]-SG-NOM	ай-маңыс
ай-мӧгӧ[PN]-SG-NOM	ай-мӧгӧ
айна[N]-SG-NOM	айна
айна[N]-VR1[V]-IMP.2SG	айнала
айна[N]-VR2[V]-IMP.2SG	айнаа
айна[N]-VR6[V]-IMP.2SG	айнақ
айры[N]-SG-NOM	айры
айт[V]-ADJR5[A]-SG-NOM	айдын
айт[V]-IMP.2SG	айт
айт[V]-NR12[N]-SG-NOM	айтпа
айт[V]-NR1[N]-SG-NOM	айдыг
айт[V]-NR1[N]-SG-NOM	айтқын
айт[V]-NR2[N]-SG-NOM	айдыш
айт[V]-NR8[N]-SG-NOM	айдақ
ай-толай[PN]-SG-NOM	ай-толай
айтта[ADV]	айтта
акел[V]-IMP.2SG	акел
акир[V]-IMP.2SG	акир
акӧке[PN]-SG-NOM	акӧке
ақ[A]-SG-NOM	ақ
ақ[A]-VR3[V]-IMP.2SG	ағар
ақ[A]-VR3[V]-NR2[N]-SG-NOM	ағарыш
ақ[V]-IMP.2SG	ақ
ақкел[V]-IMP.2SG	ақкел
ақкир[V]-IMP.2SG	ақкир
ақ-кӧбӱк[PN]-SG-NOM	ақ-кӧбӱк
ақ-кӧжеге[PN]-SG-NOM	ақ-кӧжеге
аққа[N]-ADVR[ADV]	аққан
аққа[N]-SG-NOM	аққа
ақ-қан[PN]-SG-NOM	ақ-қан
ақ-молат[PN]-SG-NOM	ақ-молат
ақ-ӧлең[PN]-SG-NOM	ақ-ӧлең
ақ-пилек[PN]-SG-NOM	ақ-пилек
ақ-пос-тайға[PN]-SG-NOM	ақ-пос-тайға
ақ-сабақ[PN]-SG-NOM	ақ-сабақ
ақ-сағал[PN]-SG-NOM	ақ-сағал
ақ-салғын[PN]-SG-NOM	ақ-салғын
ақ-сарат[N]-SG-NOM	ақ-сарат
ақ-сарат[N]-VR1[V]-IMP.2SG	ақ-саратта
ақ-сибечин[PN]-SG-NOM	ақ-сибечин
ақсы[N]-ADVR[ADV]	ақсын
ақсы[N]-ATTR1[A]-SG-NOM	ақсылыг
ақсы[N]-SG-NOM	ақсы
ақсы[N]-VR1[V]-IMP.2SG	ақсыла
ақта[V]-IMP.2SG	ақта
ақ-тек[N]-SG-NOM	ақ-тек
ақча[N]-SG-NOM	ақча
ал[V]-ADJR3[A]-SG-NOM	алғай
ал[V]-ADJR5[A]-SG-LOC-ATTR4[A]-SG-NOM	алындағы
ал[V]-ADJR5[A]-SG-NOM	алын
ал[V]-IMP.2SG	ал
ал[V]-NR12[N]-ADVR[ADV]	албан
ал[V]-NR12[N]-SG-NOM	алба
ал[V]-NR1[N]-SG-NOM	алқын
ал[V]-NR1[N]-SG-NOM	алыг
ал[V]-NR2[N]-SG-NOM	алыш
ал[V]-NR3[N]-ADVR[ADV]	алғын
ал[V]-NR4[N]-SG-NOM	алғыш
ал[V]-NR7[N]-SG-NOM	алым
ала[PSTP]	ала
ала-қабырға[PN]-SG-NOM	ала-қабырға
алақан[N]-SG-NOM	алақан
алаққан[N]-SG-NOM	алаққан
алаққан[N]-VR1[V]-IMP.2SG	алаққанна
алаққан[N]-VR2[V]-IMP.2SG	алаққана
ала-марс[PN]-SG-NOM	ала-марс
албаа[N]-ADVR[ADV]	албаан
албаа[N]-SG-NOM	албаа
албан[N]-ADVR[ADV]	албанын
албан[N]-SG-NOM	албан
албан[N]-VR1[V]-IMP.2SG	албанна
албыға[N]-SG-NOM	албыға
алға[V]-ADJR5[A]-SG-NOM	алған
алға[V]-IMP.2SG	алға
алға[V]-NR6[N]-SG-NOM	алғат
алға[V]-NR7[N]-SG-NOM	алғам
алғый[N]-SG-NOM	алғый
алғый[N]-VR1[V]-IMP.2SG	алғыйла
ален[V]-IMP.2SG	ален
алта[V]-ADJR5[A]-SG-NOM	алтан
алта[V]-IMP.2SG	алта
алтон[NUM]-ACC-PRED.2SG	алтоннуң
алтон[NUM]-ACC-PRED.2SG	алтонның
алтон[NUM]-GEN	алтонның
алтон[NUM]-NOM	алтон
алты[N]-ADVR[ADV]-ATTR2[A]-SG-NOM	алтынғы
алты[N]-ADVR[ADV]	алтын
алты[N]-ATTR2[A]-SG-NOM	алтығы
алты[N]-SG-GEN-ATTR2[A]-SG-NOM	+?
алты[N]-SG-NOM	алты
алты[NUM]-ACC=EMP1	алтыноқ
алты[NUM]-ACC-PRED.2SG	алтының
алты[NUM]-ACC	алтыны
алты[NUM]-GEN-ATTR2[A]-SG-NOM	+?
алты[NUM]-GEN	алтыаң
алты[NUM]-GEN	алтының
алты[NUM]-INST	алтыба
алты[NUM]-INST	алтыбыла
алты[NUM]-NOM-PRED.2SG	алтың
алты[NUM]-NOM	алты
алты[NUM]-POSS.1SG-DAT	алтыма
алты[NUM]-POSS.1SG-DAT	алтымға
алты[NUM]-POSS.2SG-DAT	алтыңа
алты[NUM]-POSS.2SG-DAT	алтыңға
алты[NUM]-POSS.2SG-NOM	алтың
алты[NUM]-POSS.3PL-NOM	алтылары
алты[NUM]-POSS.3SG-ACC	алтызын
алты[NUM]-POSS.3SG-INST	алтызыба
алты[NUM]-POSS.3SG-INST	алтызыбыла
алты[NUM]-POSS.3SG-NOM	алтызы
алты[N]-VR3[V]-IMP.2SG	алтыр
алтын[A]-SG-LOC-ATTR4[A]-SG-NOM	алтындағы
алтын[A]-SG-NOM	алтын
алтын[N]-ATTR2[A]-SG-NOM	алтынғы
алтын[N]-SG-LOC-ATTR4[A]-SG-NOM	алтындағы
алтын[N]-SG-NOM	алтын
алтын[N]-VR2[V]-IMP.2SG	алтына
алтын-алып[PN]-SG-NOM	алтын-алып
алтын-арыг[PN]-SG-NOM	алтын-арыг
алтын-кестик[PN]-SG-NOM	алтын-кестик
алтын-киндик[PN]-SG-NOM	алтын-киндик
алтын-кӧк[PN]-SG-NOM	алтын-кӧк
алтын-кӧӧк[PN]-SG-NOM	алтын-кӧӧк
алтын-кӱмӱш[PN]-SG-NOM	алтын-кӱмӱш
алтын-қан[PN]-SG-NOM	алтын-қан
алтын-қас[PN]-SG-NOM	алтын-қас
алтын-қожуг[PN]-SG-NOM	алтын-қожуг
алтын-қоста[PN]-SG-NOM	алтын-қоста
алтын-қурчу[PN]-SG-NOM	алтын-қурчу
алтын-қушқа[PN]-SG-NOM	алтын-қушқа
алтын-қылыш[PN]-SG-NOM	алтын-қылыш
алтын-маңнық[PN]-SG-NOM	алтын-маңнық
алтын-мас[PN]-SG-NOM	алтын-мас
алтын-мӧке[PN]-SG-NOM	алтын-мӧке
алтын-мӧкӧ[PN]-SG-NOM	алтын-мӧкӧ
алтын-оолақ[PN]-SG-NOM	алтын-оолақ
алтын-перисте[PN]-SG-NOM	алтын-перисте
алтын-перисте-қан[PN]-SG-NOM	алтын-перисте-қан
алтын-пурба[PN]-SG-NOM	алтын-пурба
алтын-сабақ[PN]-SG-NOM	алтын-сабақ
алтын-салғын[PN]-SG-NOM	алтын-салғын
алтын-сом[PN]-SG-NOM	алтын-сом
алтын-сырық[PN]-SG-NOM	алтын-сырық
алтын-тайға[PN]-SG-NOM	алтын-тайға
алтын-тайчы[PN]-SG-NOM	алтын-тайчы
алтын-тарақ[PN]-SG-NOM	алтын-тарақ
алтын-тас[PN]-SG-NOM	алтын-тас
алтын-таш[PN]-SG-NOM	алтын-таш
алтын-топчу[PN]-SG-NOM	алтын-топчу
алтын-торғу[PN]-SG-NOM	алтын-торғу
алтын-тӱлгӱ[PN]-SG-NOM	алтын-тӱлгӱ
алтын-чӱстӱк[PN]-SG-NOM	алтын-чӱстӱк
алтын-шапа[PN]-SG-NOM	алтын-шапа
алтын-шаппа[PN]-SG-NOM	алтын-шаппа
алтын-шачақ[PN]-SG-NOM	алтын-шачақ
алтын-шур[PN]-SG-NOM	алтын-шур
алтын-эргек[PN]-SG-NOM	алтын-эргек
алым[N]-SG-NOM	алым
алым[N]-VR2[V]-IMP.2SG	алма
алында[ADV]-ATTR2[A]-SG-NOM	алындағы
алында[ADV]	алында
алып[N]-ADVR[ADV]	алыбын
алып[N]-SG-NOM	алып
алып[N]-VR1[V]-IMP.2SG	алыпта
алып-қарачын[PN]-SG-NOM	алып-қарачын
алып-қус[PN]-SG-NOM	алып-қус
алып-қусқун[PN]-SG-NOM	алып-қусқун
алып-масқачақ[PN]-SG-NOM	алып-масқачақ
алып-чеқатай[PN]-SG-NOM	алып-чеқатай
алып-челбеген[PN]-SG-NOM	алып-челбеген
алып-шадай[PN]-SG-NOM	алып-шадай
ам[ADV]	ам
ам[N]-SG-NOM	ам
амды[ADV]1	+?
амды[ADV]-ATTR2[A]-SG-NOM	амдығы
амды[ADV]	амды
анмар[N]-SG-NOM	анмар
аныг[N]-SG-NOM	аныг
аң[N]-AG-VR1[V]-IMP.2SG	аңчыла
аң[N]-SG-NOM	аң
аң[N]-VR1[V]-ADJR5[A]-SG-NOM	аңнан
аң[N]-VR1[V]-IMP.2SG	аңна
аңдар[V]-IMP.2SG	аңдар
апар[V]-IMP.2SG	апар
аппар[V]-IMP.2SG	аппар
аппар[V]-NR12[N]-SG-NOM	аппарба
апсақ[N]-SG-NOM	апсақ
апсақ[N]-VR1[V]-IMP.2SG	апсақта
апшақ[N]-SG-NOM	апшақ
апшый[N]-SG-NOM	апшый
апшый[N]-VR1[V]-IMP.2SG	апшыйла
ара[N]-ADVR[ADV]	аран
ара[N]-SG-NOM	ара
ара[N]-VR1[V]-IMP.2SG	арла
ара[N]-VR2[V]-IMP.2SG	араа
ара[N]-VR6[V]-IMP.2SG	арақ
араға[N]-SG-NOM	араға
аразында[PSTP]	аразында
арал[N]-SG-NOM	арал
арал[N]-VR2[V]-IMP.2SG	арла
аран-тайчы[PN]-SG-NOM	аран-тайчы
аран-шачақ[PN]-SG-NOM	аран-шачақ
ара-чара[ADV]	ара-чара
арба[V]-NR5[N]-ATTR1[A]-SG-NOM	арбақтыг
арба[V]-NR5[N]-SG-NOM	арбақ
арға[N]-ADVR[ADV]	арған
арға[N]-ATTR1[A]-SG-NOM	арғалыг
арға[N]-SG-NOM	арға
арға[N]-VR1[V]-IMP.2SG	арғала
арғас[N]-SG-NOM	арғас
арғулус[N]-SG-NOM	арғулус
арғы[N]-ATTR1[A]-SG-NOM	арғылыг
арғы[N]-SG-NOM	арғы
арғыш[N]-ADVR[ADV]	арғыжын
арғыш[N]-SG-NOM	арғыш
арда[V]-IMP.2SG	арда
арий[ADV]	арий
арла[V]-IMP.2SG	арла
арла[V]-NR2[N]-SG-NOM	арлаш
арла[V]-NR5[N]-SG-NOM	арлақ
арла[V]-NR6[N]-SG-NOM	арлат
арта[V]-IMP.2SG	арта
арты[V]-ADJR5[A]-SG-NOM	артын
арты[V]-IMP.2SG	арты
арты[V]-NR1[N]-ADVR[ADV]	артығын
арты[V]-NR1[N]-ADVR[ADV]	артықынын
арты[V]-NR1[N]-SG-NOM	артыг
арты[V]-NR1[N]-SG-NOM	артықын
арты[V]-NR3[N]-ADVR[ADV]	артығын
арты[V]-NR3[N]-SG-NOM	артығы
арты[V]-NR5[N]-ADVR[ADV]	артығын
арты[V]-NR5[N]-SG-NOM	артық
арты[V]-NR9[N]-SG-NOM	артыл
артық[A]-SG-NOM	артық
артын[PSTP]	артын
артыс[V]-IMP.2SG	артыс
артыс[V]-NR12[N]-SG-NOM	артыспа
арыг[A]-SG-NOM	арыг
арық[N]-SG-NOM	арық
арын[V]-IMP.2SG	арын
арыт[V]-IMP.2SG	арыт
ас[N]-ADVR[ADV]	азын
ас[N]-SG-NOM	ас
ас[N]-VR6[V]-IMP.2SG	азық
ас[V]-ADJR5[A]-SG-NOM	азын
ас[V]-IMP.2SG	ас
ас[V]-NR12[N]-SG-NOM	аспа
ас[V]-NR1[N]-SG-NOM	азыг
ас[V]-NR1[N]-SG-NOM	асқын
ас[V]-NR5[N]-SG-NOM	азық
ас[V]-NR8[N]-ADVR[ADV]	азағын
ас[V]-NR8[N]-ATTR1[A]-SG-NOM	азақтыг
ас[V]-NR8[N]-SG-NOM	азақ
асқабычақ[N]-SG-NOM	асқабычақ
асқай[N]-VR1[V]-IMP.2SG	асқайла
асқы[N]-VR3[V]-IMP.2SG	асқыр
асқыр[N]-SG-NOM	асқыр
ат[N]-ADVR[ADV]	адын
ат[N]-ATTR1[A]-SG-NOM	аттыг
ат[N]-SG-NOM	ат
ат[N]-VR1[V]-IMP.2SG	атта
ат[N]-VR2[V]-ADJR5[A]-SG-NOM	адан
ат[N]-VR2[V]-IMP.2SG	ада
ат[N]-VR3[V]-IMP.2SG	адар
ат[V]-ADJR5[A]-SG-NOM	адын
ат[V]-IMP.2SG	ат
ат[V]-NR12[N]-SG-NOM	атпа
ат[V]-NR13[N]-SG-NOM	атчақ
ат[V]-NR2[N]-SG-NOM	адыш
ат[V]-NR7[N]-SG-NOM	адым
атты[V]-IMP.2SG	атты
атты[V]-NR1[N]-SG-NOM	аттыг
атты[V]-NR1[N]-SG-NOM	аттықын
атты[V]-NR2[N]-SG-NOM	аттыш
атты[V]-NR5[N]-SG-NOM	аттық
атты[V]-NR6[N]-SG-NOM	аттыт
атты[V]-NR7[N]-SG-NOM	аттым
атты[V]-NR9[N]-SG-NOM	аттыл
ача[N]-SG-NOM	ача
ача[N]-VR1[V]-IMP.2SG	ачала
ачы[V]-ADJR5[A]-SG-NOM	ачын
ачы[V]-IMP.2SG	ачы
ачы[V]-NR1[N]-ADVR[ADV]	ачығын
ачы[V]-NR1[N]-ADVR[ADV]	ачықынын
ачы[V]-NR1[N]-SG-NOM	ачыг
ачы[V]-NR1[N]-SG-NOM	ачықын
ачы[V]-NR3[N]-ADVR[ADV]	ачығын
ачы[V]-NR3[N]-SG-NOM	ачығы
ачы[V]-NR5[N]-ADVR[ADV]	ачығын
ачы[V]-NR5[N]-SG-LOC-ATTR4[A]-SG-NOM	ачықтағы
ачы[V]-NR5[N]-SG-NOM	ачық
ачы[V]-NR6[N]-SG-NOM	ачыт
ачыг[A]-SG-NOM	ачыг
ачыг[N]-ADVR[ADV]	ачығын
ачыг[N]-SG-NOM	ачыг
ачыг[N]-VR1[V]-IMP.2SG	ачығла
ачыг[N]-VR2[V]-ADJR5[A]-SG-NOM	ачыған
ачыг[N]-VR2[V]-IMP.2SG	ачыға
ачығ[N]-ADVR[ADV]	ачығын
ачығ[N]-SG-NOM	ачығ
ачығ[N]-VR1[V]-IMP.2SG	ачығла
ачығ[N]-VR2[V]-ADJR5[A]-SG-NOM	ачыған
ачығ[N]-VR2[V]-IMP.2SG	ачыға
ачый[N]-ADVR[ADV]	ачыйын
ачый[N]-SG-NOM	ачый
ачық[N]-ADVR[ADV]	ачығын
ачық[N]-SG-LOC-ATTR4[A]-SG-NOM	ачықтағы
ачық[N]-SG-NOM	ачық
ачық[N]-VR1[V]-IMP.2SG	ачықта
ачық[N]-VR2[V]-ADJR5[A]-SG-NOM	ачыған
ачық[N]-VR2[V]-IMP.2SG	ачыға
аш[N]-ADVR[ADV]	ажын
аш[N]-SG-NOM	аш
аш[N]-VR1[V]-IMP.2SG	ашта
аш[N]-VR2[V]-IMP.2SG	ажа
аш[N]-VR3[V]-IMP.2SG	ажар
аш[N]-VR6[V]-IMP.2SG	ажық
аш[V]-ADJR5[A]-SG-NOM	ажын
аш[V]-IMP.2SG	аш
аш[V]-NR11[N]-SG-NOM	ашпақ
аш[V]-NR12[N]-SG-NOM	ашпа
аш[V]-NR1[N]-SG-NOM	ажыг
аш[V]-NR1[N]-SG-NOM	ашқын
аш[V]-NR2[N]-SG-NOM	ажыш
аш[V]-NR3[N]-SG-NOM	ашқы
аш[V]-NR7[N]-SG-NOM	ажым
ашқым[N]-ATTR1[A]-SG-NOM	ашқымныг
ашқым[N]-SG-NOM	ашқым
ашта[V]-IMP.2SG	ашта
ашта[V]-NR2[N]-SG-NOM	ашташ
аш-табақ[N]-ADVR[ADV]	аш-табағын
аш-табақ[N]-SG-NOM	аш-табақ
аш-табақ[N]-VR2[V]-IMP.2SG	аш-табаға
ашық[V]-IMP.2SG	ашық
ба[PART]	ба
бе[PART]	бе
да[PART]	да
дағы[PART]	дағы
ижен[V]-IMP.2SG	ижен
изеңе[N]-SG-NOM	изеңе
изеңе[N]-VR1[V]-IMP.2SG	изеңне
изеп[N]-ADVR[ADV]	изебин
изеп[N]-SG-NOM	изеп
изиг[A]-SG-NOM	изиг
изиг[N]-SG-NOM	изиг
изий[N]-SG-NOM	изий
изит[V]-IMP.2SG	изит
иик[N]-SG-NOM	иик
иир[N]-ATTR2[A]-SG-NOM	иирги
иир[N]-SG-NOM	иир
иир[V]-IMP.2SG	иир
иир[V]-NR3[N]-SG-NOM	иирги
ийгеле[NUM]-NOM	ийгеле
ийгеле[NUM]-POSS.3SG-ACC	ийгелезин
ийгеле[NUM]-POSS.3SG-NOM	ийгелези
ийги[NUM]-ACC	ийгини
ийги[NUM]-DAT	ийгиге
ийги[NUM]-INST	ийгибе
ийги[NUM]-INST	ийгибиле
ийги[NUM]-NOM	ийги
ийги[NUM]-POSS.3SG-ACC-PRED.2SG	ийгизиниң
ийги[NUM]-POSS.3SG-ACC	ийгизин
ийги[NUM]-POSS.3SG-GEN	ийгизиниң
ийгиле[V]-IMP.2SG	ийгиле
илчирбе[N]-SG-NOM	илчирбе
илчирбе[N]-VR1[V]-IMP.2SG	илчирбеле
ин[N]-SG-NOM	ин
инге[N]-SG-NOM	инге
ирик[N]-SG-NOM	ирик
ириң[N]-SG-NOM	ириң
ириң-тас[PN]-SG-NOM	ириң-тас
ис[N]-SG-NOM	ис
ис[N]-VR1[V]-IMP.2SG	исте
ит[N]-SG-NOM	ит
ит[N]-VR2[V]-IMP.2SG	иде
ит[V]-IMP.2SG	ит
ича[N]-SG-NOM	ича
иче[N]-ATTR1[A]-SG-NOM	ичелиг
иче[N]-SG-NOM	иче
иш[N]-SG-NOM	иш
иш[N]-VR1[V]-ADJR5[A]-SG-NOM	иштен
иш[N]-VR1[V]-IMP.2SG	иште
иш[N]-VR2[V]-IMP.2SG	иже
иш[N]-VR3[V]-IMP.2SG	ижер
иш[V]-IMP.2SG	иш
иш[V]-NR12[N]-SG-NOM	ишпе
иш[V]-NR6[N]-SG-NOM	ижит
ишти[N]-ADVR[ADV]	иштин
ишти[N]-SG-NOM	ишти
ишти[N]-VR1[V]-IMP.2SG	иштиле
ишти[N]-VR3[V]-IMP.2SG	иштир
иштинге[PSTP]	иштинге
иштинде[ADV]-ATTR2[A]-SG-NOM	иштиндеги
иштинде[ADV]	иштинде
иштинде[PSTP]	иштинде
кебе[N]-SG-NOM	кебе
кебеге[N]-SG-NOM	кебеге
кедере[ADV]	кедере
кежире[PSTP]	кежире
кезек[N]-SG-NOM	кезек
кей[N]-SG-NOM	кей
кекс[N]-SG-NOM	кекс
кел[V]-ADJR5[A]-SG-NOM	келин
кел[V]-IMP.2SG	кел
кел[V]-NR12[N]-SG-NOM	келбе
кел[V]-NR2[N]-SG-NOM	келиш
кел[V]-NR3[N]-SG-NOM	келги
кел[V]-NR7[N]-SG-NOM	келим
келин[N]-SG-NOM	келин
кене[V]-NR6[N]-ATTR2[A]-SG-NOM	кенетки
кенетки[ADV]	кенетки
кең[A]-SG-NOM	кең
кең[N]-SG-NOM	кең
кеп[N]-ADVR[ADV]	кебин
кеп[N]-ATTR1[A]-SG-NOM	кептиг
кеп[N]-SG-NOM	кеп
кеп[N]-VR1[V]-ADJR5[A]-SG-NOM	кептен
кеп[N]-VR1[V]-IMP.2SG	кепте
кер[A]-SG-NOM	кер
кере[N]-ATTR2[A]-SG-NOM	кереги
кере[N]-SG-NOM	кере
кере[N]-VR6[V]-IMP.2SG	кереқ
кере[V]-IMP.2SG	кере
кере[V]-NR2[N]-SG-NOM	кереш
кере[V]-NR3[N]-SG-NOM	кереги
кере[V]-NR5[N]-SG-NOM	кереқ
керек[N]-SG-NOM	керек
керек[N]-VR1[V]-IMP.2SG	керекте
керсе[A]-SG-NOM	керсе
керсе[N]-SG-NOM	керсе
керт[V]-IMP.2SG	керт
кес[V]-IMP.2SG	кес
кести[N]-SG-NOM	кести
кести[N]-VR1[V]-IMP.2SG	кестиле
кести[N]-VR3[V]-IMP.2SG	кестир
кестик[N]-SG-NOM	кестик
кестинде[PSTP]	кестинде
кече[ADV]-ATTR2[A]-SG-NOM	кечеги
кече[ADV]	кече
кеш[V]-IMP.2SG	кеш
кеш[V]-NR12[N]-SG-NOM	кешпе
кеш[V]-NR1[N]-SG-NOM	кежиг
кеш[V]-NR1[N]-SG-NOM	кешқин
кижен-мӧке[PN]-SG-NOM	кижен-мӧке
кижи[N]-ADVR[ADV]	кижин
кижи[N]-SG-NOM	кижи
кижи[N]-VR1[V]-IMP.2SG	кижиле
киис[N]-SG-NOM	киис
кийик[N]-SG-NOM	кийик
кир[N]-SG-NOM	кир
кир[N]-VR1[V]-IMP.2SG	кирле
кир[N]-VR2[V]-IMP.2SG	кире
кир[N]-VR3[V]-IMP.2SG	кирер
кир[V]-ADJR5[A]-SG-NOM	кирин
кир[V]-IMP.2SG	кир
кир[V]-NR12[N]-SG-NOM	кирбе
кир[V]-NR2[N]-SG-NOM	кириш
кирбик[N]-SG-NOM	кирбик
кире[PSTP]	кире
кирлес[N]-SG-NOM	кирлес
кирлес[N]-VR1[V]-IMP.2SG	кирлесте
кичен[V]-IMP.2SG	кичен
кичиг[A]-SG-NOM	кичиг
киш[N]-ADVR[ADV]	кижин
киш[N]-SG-NOM	киш
киш[N]-VR1[V]-IMP.2SG	киште
киш[N]-VR2[V]-ADJR5[A]-SG-NOM	кижен
киш[N]-VR2[V]-IMP.2SG	киже
кӧбӱзи[N]-SG-NOM	кӧбӱзи
кӧбӱк[N]-SG-NOM	кӧбӱк
кӧг[N]-VR7[V]-IMP.2SG	кӧгер
кӧгей-алып[PN]-SG-NOM	кӧгей-алып
кӧгле[V]-IMP.2SG	кӧгле
кӧгле[V]-NR2[N]-SG-NOM	кӧглеш
кӧгле[V]-NR6[N]-SG-NOM	кӧглет
кӧгӱ[V]-IMP.2SG	кӧгӱ
кӧгӱс[N]-ATTR1[A]-SG-NOM	кӧгӱстиг
кӧгӱс[N]-SG-NOM	кӧгӱс
кӧдре[N]-SG-NOM	кӧдре
кӧдӱр[V]-IMP.2SG	кӧдӱр
кӧдӱрбе[N]-VR2[V]-ADJR5[A]-SG-NOM	кӧдӱрбеен
кӧдӱрбе[N]-VR2[V]-IMP.2SG	кӧдӱрбее
кӧдӱрге[N]-SG-NOM	кӧдӱрге
кӧдӱре[N]-SG-NOM	кӧдӱре
кӧжеге[N]-SG-NOM	кӧжеге
кӧзӱнек[N]-SG-NOM	кӧзӱнек
кӧй[V]-IMP.2SG	кӧй
кӧй[V]-NR2[N]-SG-NOM	кӧйиш
кӧй[V]-NR2[N]-SG-NOM	кӧйӱш
кӧк[A]-SG-NOM	кӧк
кӧк[N]-SG-NOM	кӧк
кӧк[N]-VR1[V]-IMP.2SG	кӧкте
кӧк[N]-VR4[V]-IMP.2SG	кӧксин
кӧк[N]-VR4[V]-IMP.2SG	кӧксӱн
кӧк-қан[PN]-SG-NOM	кӧк-қан
кӧк-ӧлең[PN]-SG-NOM	кӧк-ӧлең
кӧк-оолақ[PN]-SG-NOM	кӧк-оолақ
кӧкс[N]-SG-NOM	кӧкс
кӧкс[N]-VR2[V]-IMP.2SG	кӧксе
кӧк-сабақ[PN]-SG-NOM	кӧк-сабақ
кӧк-салғын[PN]-SG-NOM	кӧк-салғын
кӧксӱ[N]-ADVR[ADV]	кӧксӱн
кӧксӱ[N]-SG-NOM	кӧксӱ
кӧк-тайға[PN]-SG-NOM	кӧк-тайға
кӧк-таш[PN]-SG-NOM	кӧк-таш
кӧк-таш-мерген[PN]-SG-NOM	кӧк-таш-мерген
кӧк-торғу[PN]-SG-NOM	кӧк-торғу
кӧк-торчуқ[PN]-SG-NOM	кӧк-торчуқ
кӧк-челбиген[PN]-SG-NOM	кӧк-челбиген
кӧк-шмелдей[PN]-SG-NOM	кӧк-шмелдей
кӧл[N]-SG-NOM	кӧл
кӧл[N]-VR2[V]-IMP.2SG	кӧле
кӧлек[N]-SG-NOM	кӧлек
кӧлек[N]-VR1[V]-ADJR5[A]-SG-NOM	кӧлектен
кӧлек[N]-VR1[V]-IMP.2SG	кӧлекте
кӧлен[V]-IMP.2SG	кӧлен
кӧлет[V]-NR3[N]-SG-NOM	кӧлетки
кӧнек[N]-SG-NOM	кӧнек
кӧңме[N]-SG-NOM	кӧңме
кӧңни[N]-SG-NOM	кӧңни
кӧңнӱ[N]-SG-NOM	кӧңнӱ
кӧӧк[N]-SG-NOM	кӧӧк
кӧӧк[N]-VR1[V]-IMP.2SG	кӧӧкте
кӧп[N]-SG-NOM	кӧп
кӧп[NUM]-ACC-PRED.2SG	кӧптиң
кӧп[NUM]-ACC-PRED.2SG	кӧптӱң
кӧп[NUM]-GEN	кӧптиң
кӧп[NUM]-NOM=EMP2	кӧп-но
кӧп[NUM]-NOM	кӧп
кӧп[N]-VR2[V]-ADJR5[A]-SG-NOM	кӧбен
кӧп[N]-VR2[V]-IMP.2SG	кӧбе
кӧп[V]-IMP.2SG	кӧп
кӧр[N]-SG-NOM	кӧр
кӧр[N]-VR2[V]-IMP.2SG	кӧре
кӧр[N]-VR3[V]-IMP.2SG	кӧрер
кӧр[V]-ADJR5[A]-SG-NOM	кӧрин
кӧр[V]-IMP.2SG	кӧр
кӧр[V]-NR2[N]-SG-NOM	кӧриш
кӧр[V]-NR2[N]-SG-NOM	кӧрӱш
кӧс[N]-SG-NOM	кӧс
кӧс[N]-VR1[V]-ADJR5[A]-SG-NOM	кӧстен
кӧс[N]-VR1[V]-IMP.2SG	кӧсте
кӧс[N]-VR2[V]-ADJR2[A]-SG-NOM	кӧзечи
кӧс[N]-VR2[V]-IMP.2SG	кӧзе
кӧче[ADV]	кӧче
кӧче[N]-SG-NOM	кӧче
кӧчӱк[N]-SG-NOM	кӧчӱк
кӧш[N]-SG-NOM	кӧш
кӧш[N]-VR2[V]-IMP.2SG	кӧже
кӧшке[N]-SG-NOM	кӧшке
кӧшке[N]-VR1[V]-IMP.2SG	кӧшкеле
крес[N]-ATTR1[A]-SG-NOM	крестиг
крес[N]-SG-NOM	крес
крес[N]-VR1[V]-IMP.2SG	кресте
кӱзе[N]-SG-NOM	кӱзе
кӱзетчи[N]-SG-NOM	кӱзетчи
кӱл[N]-ADVR[ADV]	кӱлин
кӱл[N]-SG-NOM	кӱл
кӱл[N]-VR1[V]-IMP.2SG	кӱлле
кӱл[N]-VR2[V]-IMP.2SG	кӱле
кӱл[N]-VR3[V]-IMP.2SG	кӱлер
кӱл[V]-ADJR5[A]-SG-NOM	кӱлин
кӱл[V]-IMP.2SG	кӱл
кӱл[V]-NR12[N]-SG-NOM	кӱлбе
кӱл[V]-NR2[N]-SG-NOM	кӱлиш
кӱл[V]-NR2[N]-SG-NOM	кӱлӱш
кӱлер[N]-SG-NOM	кӱлер
кӱлкӱ[N]-SG-NOM	кӱлкӱ
кӱл-орғу[PN]-SG-NOM	кӱл-орғу
кӱлӱк[N]-SG-NOM	кӱлӱк
кӱлӱк[N]-VR1[V]-IMP.2SG	кӱлӱкте
кӱмӱш[N]-SG-NOM	кӱмӱш
кӱмӱш-қылыш[PN]-SG-NOM	кӱмӱш-қылыш
кӱмӱш-сом[PN]-SG-NOM	кӱмӱш-сом
кӱмӱш-шачақ[PN]-SG-NOM	кӱмӱш-шачақ
кӱн[N]-ATTR1[A]-SG-NOM	кӱнниг
кӱн[N]-SG-NOM	кӱн
кӱн[N]-VR1[V]-IMP.2SG	кӱнне
кӱн-арыг[PN]-SG-NOM	кӱн-арыг
кӱнегей[N]-SG-NOM	кӱнегей
кӱнек[N]-SG-NOM	кӱнек
кӱн-кӧӧк[PN]-SG-NOM	кӱн-кӧӧк
кӱн-қан[PN]-SG-NOM	кӱн-қан
кӱн-қаны[PN]-SG-NOM	кӱн-қаны
кӱнӱк[N]-SG-NOM	кӱнӱк
кӱре[V]-IMP.2SG	кӱре
кӱре[V]-NR2[N]-SG-NOM	кӱреш
кӱре[V]-NR6[N]-SG-NOM	кӱрет
кӱрең-қылыш[PN]-SG-NOM	кӱрең-қылыш
кӱрчек[N]-SG-NOM	кӱрчек
кӱскӱ[N]-SG-NOM	кӱскӱ
кӱӱлек[N]-SG-NOM	кӱӱлек
кӱш[N]-ADVR[ADV]	кӱжин
кӱш[N]-ATTR1[A]-SG-NOM	кӱштиг
кӱш[N]-SG-NOM	кӱш
кӱш[N]-VR1[V]-IMP.2SG	кӱште
қаар[V]-IMP.2SG	қаар
қаар[V]-NR13[N]-SG-NOM	қаарчақ
қаат[N]-ATTR1[A]-SG-NOM	қааттыг
қаат[N]-SG-NOM	қаат
қабақ[N]-ADVR[ADV]	қабағын
қабақ[N]-ATTR1[A]-SG-NOM	қабақтыг
қабақ[N]-SG-NOM	қабақ
қабақ[N]-SG-POSS.3SG-LOC-ATTR4[A]-SG-NOM	қабағындағы
қабар[N]-SG-NOM	қабар
қабыл[V]-IMP.2SG	қабыл
қабыл[V]-NR2[N]-SG-NOM	қабылыш
қабын[V]-IMP.2SG	қабын
қабырға[N]-SG-NOM	қабырға
қабырға[N]-VR1[V]-IMP.2SG	қабырғала
қабыш[N]-SG-NOM	қабыш
қабыш[N]-VR2[V]-IMP.2SG	қабыжа
қабыш[N]-VR3[V]-ADJR5[A]-SG-NOM	қабыжарын
қабыш[N]-VR3[V]-IMP.2SG	қабыжар
қабыш[V]-IMP.2SG	қабыш
қабыш[V]-NR2[N]-SG-NOM	қабыжыш
қаг[V]-ADJR5[A]-SG-NOM	қағын
қаг[V]-IMP.2SG	қаг
қаг[V]-NR2[N]-SG-NOM	қағыш
қада[V]-ADJR2[A]-SG-NOM	қадачы
қада[V]-ADJR5[A]-SG-NOM	қадан
қада[V]-IMP.2SG	қада
қадар[V]-IMP.2SG	қадар
қадар[V]-NR12[N]-SG-NOM	қадарба
қадачы[N]-SG-NOM	қадачы
қадыл[N]-SG-NOM	қадыл
қадыл[N]-VR2[V]-IMP.2SG	қадыла
қаза[V]-ADJR5[A]-SG-NOM	қазан
қаза[V]-IMP.2SG	қаза
қаза[V]-NR5[N]-SG-NOM	қазақ
қаза[V]-NR9[N]-SG-NOM	қазал
қазақ[A]-SG-NOM	қазақ
қазан[N]-SG-NOM	қазан
қазан[N]-VR1[V]-IMP.2SG	қазанна
қазы[N]-ADVR[ADV]	қазын
қазы[N]-SG-NOM	қазы
қазы[N]-VR3[V]-IMP.2SG	қазыр
қазы[N]-VR8[V]-IMP.2SG	қазыра
қазың[N]-SG-NOM	қазың
қазың[N]-VR1[V]-IMP.2SG	қазыңна
қазыр[A]-SG-NOM	қазыр
қазыр-тек[PN]-SG-NOM	қазыр-тек
қай[N]-ADVR[ADV]	қайын
қай[N]-SG-LOC-ATTR4[A]-SG-NOM	қайдағы
қай[N]-SG-NOM	қай
қай[N]-VR1[V]-ADJR5[A]-SG-NOM	қайлан
қай[N]-VR1[V]-IMP.2SG	қайла
қай[N]-VR2[V]-IMP.2SG	қайа
қай[N]-VR3[V]-IMP.2SG	қайар
қай[N]-VR8[V]-ADJR5[A]-SG-LOC-ATTR4[A]-SG-NOM	қайрандағы
қай[N]-VR8[V]-ADJR5[A]-SG-NOM	қайран
қай[N]-VR8[V]-IMP.2SG	қайра
қайа[N]-SG-NOM	қайа
қайа[N]-VR1[V]-ADJR5[A]-SG-NOM	қайлан
қайа[N]-VR1[V]-IMP.2SG	қайла
қайа[N]-VR2[V]-IMP.2SG	қайаа
қайа[N]-VR3[V]-IMP.2SG	қайар
қайа[N]-VR6[V]-IMP.2SG	қайақ
қайақ[N]-SG-NOM	қайақ
қайде[ADV]1	+?
қайде[ADV]	қайде
қайна[V]-IMP.2SG	қайна
қайра[ADV]	қайра
қайра[V]-ADJR5[A]-SG-LOC-ATTR4[A]-SG-NOM	қайрандағы
қайра[V]-ADJR5[A]-SG-NOM	қайран
қайра[V]-IMP.2SG	қайра
қайран[A]-SG-LOC-ATTR4[A]-SG-NOM	қайрандағы
қайран[A]-SG-NOM	қайран
қайры[N]-SG-NOM	қайры
қайыг[N]-SG-NOM	қайыг
қайын[V]-IMP.2SG	қайын
қайыш[N]-SG-NOM	қайыш
қайыш[N]-VR1[V]-IMP.2SG	қайышта
қақ[V]-ADJR5[A]-SG-NOM	қағын
қақ[V]-IMP.2SG	қақ
қақ[V]-NR12[N]-SG-NOM	қақпа
қақ[V]-NR2[N]-SG-NOM	қағыш
қал[A]-SG-NOM	қал
қал[A]-VR3[V]-IMP.2SG	қалар
қал[V]-ADJR3[A]-SG-NOM	қалғай
қал[V]-ADJR5[A]-SG-NOM	қалын
қал[V]-IMP.2SG	қал
қал[V]-NR11[N]-SG-NOM	қалбақ
қал[V]-NR12[N]-ATTR2[A]-SG-NOM	қалбағы
қал[V]-NR12[N]-SG-NOM	қалба
қал[V]-NR13[N]-SG-NOM	қалчақ
қал[V]-NR2[N]-SG-NOM	қалыш
қал[V]-NR5[N]-SG-NOM	қалық
қал[V]-NR8[N]-SG-NOM	қалақ
қалақ[N]-SG-NOM	қалақ
қалақ[N]-VR1[V]-IMP.2SG	қалақта
қалақ[N]-VR2[V]-IMP.2SG	қалқа
қалат[N]-SG-NOM	қалат
қалат[N]-VR2[V]-IMP.2SG	қалта
қалат[N]-VR3[V]-IMP.2SG	қалтар
қалаш[N]-SG-NOM	қалаш
қалба[N]-ATTR2[A]-SG-NOM	қалбағы
қалба[N]-SG-NOM	қалба
қалба[N]-VR2[V]-ADJR5[A]-SG-NOM	қалбаан
қалба[N]-VR2[V]-IMP.2SG	қалбаа
қалба[N]-VR6[V]-IMP.2SG	қалбақ
қалқа[N]-ATTR1[A]-SG-NOM	қалқалыг
қалқа[N]-SG-NOM	қалқа
қалпақ[N]-ADVR[ADV]	қалпағын
қалпақ[N]-SG-NOM	қалпақ
қалық[ADV]	қалық
қалық[N]-SG-NOM	қалық
қалық[N]-VR1[V]-IMP.2SG	қалықта
қалық[N]-VR2[V]-IMP.2SG	қалқа
қалыққа[N]-SG-NOM	қалыққа
қалын[A]-SG-NOM	қалын
қалын[N]-SG-NOM	қалын
қалып[N]-SG-NOM	қалып
қам[N]-SG-NOM	қам
қам[N]-VR1[V]-IMP.2SG	қамна
қаморта[ADV]	қаморта
қаморта[N]-SG-NOM	қаморта
қамчы[N]-SG-NOM	қамчы
қамыш[N]-SG-NOM	қамыш
қамыш[N]-VR1[V]-IMP.2SG	қамышта
қан[N]-ADVR[ADV]	қанын
қан[N]-SG-NOM	қан
қан[N]-VR1[V]-IMP.2SG	қанна
қан[N]-VR2[V]-IMP.2SG	қана
қан[N]-VR6[V]-IMP.2SG	қанық
қан-алып[PN]-SG-NOM	қан-алып
қан-арғо[PN]-SG-NOM	қан-арғо
қанат[N]-ATTR1[A]-SG-NOM	қанаттыг
қанат[N]-SG-NOM	қанат
қанат[N]-VR1[V]-ADJR5[A]-SG-NOM	қанаттан
қанат[N]-VR1[V]-IMP.2SG	қанатта
қан-кезер[PN]-SG-NOM	қан-кезер
қан-кес[PN]-SG-NOM	қан-кес
қан-кичей[PN]-SG-NOM	қан-кичей
қан-кӧӧк[PN]-SG-NOM	қан-кӧӧк
қан-қарачақ[PN]-SG-NOM	қан-қарачақ
қан-қоста[PN]-SG-NOM	қан-қоста
қан-қыйған[PN]-SG-NOM	қан-қыйған
қан-қыйғанақ[PN]-SG-NOM	қан-қыйғанақ
қан-қылыш[PN]-SG-NOM	қан-қылыш
қан-қыс[PN]-SG-NOM	қан-қыс
қан-мерген[PN]-SG-NOM	қан-мерген
қан-оолақ[PN]-SG-NOM	қан-оолақ
қан-перген[PN]-SG-NOM	қан-перген
қан-сабақ[PN]-SG-NOM	қан-сабақ
қан-сарыг[PN]-SG-NOM	қан-сарыг
қан-сыбазын-оолақ[PN]-SG-NOM	қан-сыбазын-оолақ
қан-тегри[PN]-SG-NOM	қан-тегри
қан-тек[PN]-SG-NOM	қан-тек
қан-чайзаң[PN]-SG-NOM	қан-чайзаң
қаңза[N]-SG-NOM	қаңза
қап[N]-ADVR[ADV]	қабын
қап[N]-AG-VR6[V]-IMP.2SG	қапчық
қап[N]-ATTR1[A]-SG-NOM	қаптыг
қап[N]-DIM2-SG-POSS.3SG-LOC-ATTR4[A]-SG-NOM	қабағындағы
қап[N]-SG-NOM	қап
қап[N]-VR1[V]-IMP.2SG	қапта
қап[N]-VR2[V]-IMP.2SG	қаба
қап[N]-VR3[V]-IMP.2SG	қабар
қап[N]-VR4[V]-IMP.2SG	қапсын
қап[V]-ADJR5[A]-SG-NOM	қабын
қап[V]-IMP.2SG	қап
қап[V]-NR13[N]-SG-NOM	қапчақ
қап[V]-NR2[N]-SG-NOM	қабыш
қап[V]-NR8[N]-ADVR[ADV]	қабағын
қап[V]-NR8[N]-ATTR1[A]-SG-NOM	қабақтыг
қап[V]-NR8[N]-SG-NOM	қабақ
қап[V]-NR8[N]-SG-POSS.3SG-LOC-ATTR4[A]-SG-NOM	қабағындағы
қапчығай[ADV]	қапчығай
қар[N]-ADVR[ADV]	қарын
қар[N]-SG-NOM	қар
қар[N]-VR2[V]-ADJR5[A]-SG-NOM	қаран
қар[N]-VR2[V]-IMP.2SG	қара
қар[N]-VR3[V]-IMP.2SG	қарар
қар[N]-VR6[V]-IMP.2SG	қарық
қар[V]-ADJR2[A]-SG-NOM	қарчы
қар[V]-ADJR5[A]-SG-NOM	қарын
қар[V]-IMP.2SG	қар
қар[V]-NR11[N]-SG-NOM	қарбақ
қар[V]-NR12[N]-ADVR[ADV]	қарбан
қар[V]-NR12[N]-SG-NOM	қарба
қар[V]-NR13[N]-SG-NOM	қарчақ
қар[V]-NR1[N]-SG-NOM	қарқын
қар[V]-NR1[N]-SG-NOM	қарыг
қар[V]-NR2[N]-SG-NOM	қарыш
қар[V]-NR4[N]-SG-NOM	қарғыш
қар[V]-NR5[N]-SG-NOM	қарық
қар[V]-NR8[N]-ADVR[ADV]	қарағын
қар[V]-NR8[N]-AG-ADVR[ADV]	қарақчын
қар[V]-NR8[N]-ATTR1[A]-SG-NOM	қарақтыг
қар[V]-NR8[N]-SG-NOM	қарақ
қара[A]-SG-NOM	қара
қара[A]-VR3[V]-IMP.2SG	қарар
қара[A]-VR3[V]-NR2[N]-SG-NOM	қарарыш
қара[A]-VR9[V]-IMP.2SG	қарар
қара[A]-VR9[V]-NR2[N]-SG-NOM	қарарыш
қара[N]-ADVR[ADV]	қаран
қара[N]-AG-ADVR[ADV]	қарачын
қара[N]-ATTR2[A]-SG-NOM	қарағы
қара[N]-SG-NOM	қара
қара[N]-VR2[V]-ADJR5[A]-SG-NOM	қараан
қара[N]-VR2[V]-IMP.2SG	қараа
қара[N]-VR3[V]-IMP.2SG	қарар
қара[N]-VR6[V]-ADJR5[A]-SG-NOM	қарағын
қара[N]-VR6[V]-IMP.2SG	қарақ
қара[N]-VR8[V]-IMP.2SG	қарара
қара[V]-ADJR5[A]-SG-NOM	қаран
қара[V]-IMP.2SG	қара
қара[V]-NR12[N]-SG-NOM	қараба
қара[V]-NR13[N]-SG-NOM	қарачақ
қара[V]-NR1[N]-ADVR[ADV]	қарағын
қара[V]-NR1[N]-ADVR[ADV]	қарақынын
қара[V]-NR1[N]-SG-NOM	қараг
қара[V]-NR1[N]-SG-NOM	қарақын
қара[V]-NR2[N]-ATTR2[A]-SG-NOM	қарашқы
қара[V]-NR3[N]-ADVR[ADV]	қарағын
қара[V]-NR3[N]-SG-NOM	қарағы
қара[V]-NR5[N]-ADVR[ADV]	қарағын
қара[V]-NR5[N]-AG-ADVR[ADV]	қарақчын
қара[V]-NR5[N]-ATTR1[A]-SG-NOM	қарақтыг
қара[V]-NR5[N]-SG-NOM	қарақ
қара[V]-NR6[N]-ADVR[ADV]	қарадын
қара[V]-NR6[N]-ATTR1[A]-SG-NOM	қараттыг
қара[V]-NR6[N]-SG-NOM	қарат
қараа[N]-ADVR[ADV]	қараан
қараа[N]-SG-NOM	қараа
қара-алып[PN]-SG-NOM	қара-алып
қаразы-қан[PN]-SG-NOM	қаразы-қан
қарақ[N]-ADVR[ADV]	қарағын
қарақ[N]-AG-ADVR[ADV]	қарақчын
қарақ[N]-ATTR1[A]-SG-NOM	қарақтыг
қарақ[N]-SG-NOM	қарақ
қарақ[N]-VR1[V]-IMP.2SG	қарақта
қара-қазан[PN]-SG-NOM	қара-қазан
қара-қайа[PN]-SG-NOM	қара-қайа
қара-қайыш[PN]-SG-NOM	қара-қайыш
қара-қан[PN]-SG-NOM	қара-қан
қара-қан-мерген[PN]-SG-NOM	қара-қан-мерген
қара-қартыға[PN]-SG-NOM	қара-қартыға
қара-қат[PN]-SG-NOM	қара-қат
қара-қылыш[PN]-SG-NOM	қара-қылыш
қара-маас[PN]-SG-NOM	қара-маас
қара-мӧке[PN]-SG-NOM	қара-мӧке
қара-молат[PN]-SG-NOM	қара-молат
қара-моңус[PN]-SG-NOM	қара-моңус
қара-моос[PN]-SG-NOM	қара-моос
қара-оолақ[PN]-SG-NOM	қара-оолақ
қара-ӧреккен[PN]-SG-NOM	қара-ӧреккен
қара-пурба[PN]-SG-NOM	қара-пурба
қара-сабақ[PN]-SG-NOM	қара-сабақ
қара-салғын[PN]-SG-NOM	қара-салғын
қара-торғу[PN]-SG-NOM	қара-торғу
қаратты-перген[PN]-SG-NOM	қаратты-перген
қара-тӱртӱс[PN]-SG-NOM	қара-тӱртӱс
қарашқы[N]-SG-NOM	қарашқы
қара-шмелдей[PN]-SG-NOM	қара-шмелдей
қара-шойун[PN]-SG-NOM	қара-шойун
қара-шӧл[PN]-SG-NOM	қара-шӧл
қарбақ[N]-SG-NOM	қарбақ
қарбақ[N]-VR1[V]-IMP.2SG	қарбақта
қарбақ[V]-IMP.2SG	қарбақ
қарға[N]-ADVR[ADV]	қарған
қарға[N]-SG-NOM	қарға
қарға[V]-ADJR5[A]-SG-NOM	қарған
қарға[V]-IMP.2SG	қарға
қарлығаш[N]-SG-NOM	қарлығаш
қарлық[N]-SG-NOM	қарлық
қарман[N]-ADVR[ADV]	қарманын
қарман[N]-SG-NOM	қарман
қарны[N]-SG-NOM	қарны
қарс[A]-SG-NOM	қарс
қартус[N]-SG-NOM	қартус
қартӱс[N]-SG-NOM	қартӱс
қартыға[N]-SG-NOM	қартыға
қарчақ[N]-SG-NOM	қарчақ
қарчақ[N]-VR2[V]-IMP.2SG	қарчаға
қарчы[A]-SG-NOM	қарчы
қарыг[N]-SG-NOM	қарыг
қарыг[N]-VR2[V]-ADJR5[A]-SG-NOM	қарған
қарыг[N]-VR2[V]-IMP.2SG	қарға
қарын[N]-ATTR1[A]-SG-NOM	қарынныг
қарын[N]-SG-NOM	қарын
қарындаш[N]-SG-NOM	қарындаш
қарындаш[N]-VR1[V]-IMP.2SG	қарындашта
қас[N]-ADVR[ADV]	қазын
қас[N]-SG-LOC-ATTR4[A]-SG-NOM	қастағы
қас[N]-SG-NOM	қас
қас[N]-VR1[V]-IMP.2SG	қаста
қас[N]-VR2[V]-ADJR5[A]-SG-NOM	қазан
қас[N]-VR2[V]-IMP.2SG	қаза
қас[V]-ADJR5[A]-SG-NOM	қазын
қас[V]-IMP.2SG	қас
қас[V]-NR8[N]-SG-NOM	қазақ
қастақ[N]-ADVR[ADV]	қастағын
қастақ[N]-SG-NOM	қастақ
қасты[N]-ATTR2[A]-SG-NOM	қастығы
қасты[N]-SG-NOM	қасты
қастық[N]-SG-NOM	қастық
қастырық[N]-ATTR1[A]-SG-NOM	қастырықтыг
қастырық[N]-SG-NOM	қастырық
қат[N]-ATTR1[A]-SG-NOM	қаттыг
қат[N]-ATTR2[A]-SG-NOM	қатқы
қат[N]-SG-NOM	қат
қат[N]-VR1[V]-ADJR5[A]-SG-NOM	қаттан
қат[N]-VR1[V]-IMP.2SG	қатта
қат[N]-VR2[V]-ADJR2[A]-SG-NOM	қадачы
қат[N]-VR2[V]-ADJR5[A]-SG-NOM	қадан
қат[N]-VR2[V]-IMP.2SG	қада
қат[N]-VR3[V]-IMP.2SG	қадар
қат[V]-IMP.2SG	қат
қат[V]-NR12[N]-SG-NOM	қатпа
қат[V]-NR1[N]-SG-NOM	қадыг
қат[V]-NR1[N]-SG-NOM	қатқын
қат[V]-NR2[N]-SG-NOM	қадыш
қат[V]-NR3[N]-SG-NOM	қатқы
қатқан-чыла[PN]-SG-NOM	қатқан-чыла
қатқы[N]-SG-NOM	қатқы
қатқы[N]-VR3[V]-IMP.2SG	қатқыр
қатқы[N]-VR8[V]-IMP.2SG	қатқыра
қатна[V]-IMP.2SG	қатна
қатна[V]-NR12[N]-SG-NOM	қатнаба
қатпаш[N]-SG-NOM	қатпаш
қатпаш[N]-VR1[V]-IMP.2SG	қатпашта
қаттан-чула[PN]-SG-NOM	қаттан-чула
қачыр[V]-IMP.2SG	қачыр
қачыр[V]-NR2[N]-SG-NOM	қачырыш
қаш[N]-SG-NOM	қаш
қаш[N]-VR1[V]-IMP.2SG	қашта
қаш[N]-VR6[V]-IMP.2SG	қажық
қашқа[N]-SG-NOM	қашқа
қашқа[N]-VR1[V]-IMP.2SG	қашқала
қашқа[N]-VR6[V]-IMP.2SG	қашқақ
қобрақ[N]-SG-NOM	қобрақ
қобу[N]-ADVR[ADV]	қобун
қобу[N]-VR3[V]-ADJR3[A]-SG-NOM	қобурғай
қобу[N]-VR3[V]-IMP.2SG	қобур
қобы[N]-VR3[V]-ADJR3[A]-SG-NOM	қобырғай
қобы[N]-VR3[V]-IMP.2SG	қобыр
қобыр[V]-ADJR3[A]-SG-NOM	қобырғай
қобыр[V]-IMP.2SG	қобыр
қобыр[V]-NR8[N]-SG-NOM	қобырақ
қодур[N]-SG-NOM	қодур
қодур[N]-VR2[V]-IMP.2SG	қодура
қодур[V]-IMP.2SG	қодур
қозан[N]-SG-NOM	қозан
қой[N]-SG-NOM	қой
қой[N]-VR1[V]-IMP.2SG	қойла
қой[N]-VR2[V]-ADJR5[A]-SG-NOM	қойан
қой[N]-VR2[V]-IMP.2SG	қойа
қойну[N]-SG-NOM	қойну
қойы[N]-VR1[V]-IMP.2SG	қойла
қол[N]-ADVR[ADV]	қолын
қол[N]-SG-NOM	қол
қол[N]-SG-POSS.2SG-LOC-ATTR4[A]-SG-NOM	қолыңдағы
қол[N]-SG-POSS.3SG-LOC-ATTR4[A]-SG-NOM	қолындағы
қол[N]-VR1[V]-IMP.2SG	қолла
қол[N]-VR2[V]-IMP.2SG	қола
қол[N]-VR3[V]-IMP.2SG	қолар
қола[N]-ATTR2[A]-SG-NOM	қолағы
қола[N]-SG-NOM	қола
қола[N]-VR1[V]-IMP.2SG	қолла
қола[N]-VR3[V]-IMP.2SG	қолар
қола[N]-VR6[V]-ADJR5[A]-SG-NOM	қолағын
қола[N]-VR6[V]-IMP.2SG	қолақ
қолаг[N]-ADVR[ADV]	қолағын
қолаг[N]-SG-NOM	қолаг
қолаг[N]-VR1[V]-IMP.2SG	қолағла
қолаг[N]-VR2[V]-IMP.2SG	қолға
қола-қырыш[PN]-SG-NOM	қола-қырыш
қолтуқ[N]-SG-NOM	қолтуқ
қолтуқ[N]-VR1[V]-ADJR5[A]-SG-NOM	қолтуқтан
қолтуқ[N]-VR1[V]-IMP.2SG	қолтуқта
қолчақ[N]-SG-NOM	қолчақ
қомус[N]-SG-NOM	қомус
қон[V]-IMP.2SG	қон
қон[V]-NR2[N]-SG-NOM	қонуш
қон[V]-NR2[N]-SG-NOM	қоныш
қон[V]-NR5[N]-SG-NOM	қонуқ
қон[V]-NR5[N]-SG-NOM	қонық
қон[V]-NR8[N]-SG-NOM	қонақ
қонақ[N]-SG-NOM	қонақ
қонақ[N]-VR1[V]-IMP.2SG	қонақта
қоол[N]-SG-NOM	қоол
қоол[N]-VR2[V]-IMP.2SG	қоола
қооп[ADV]	қооп
қоор[V]-IMP.2SG	қоор
қоора[N]-VR1[V]-IMP.2SG	қоорла
қопта[V]-IMP.2SG	қопта
қор[A]-SG-NOM	қор
қора[V]-IMP.2SG	қора
қора[V]-NR6[N]-ADVR[ADV]	қорадын
қора[V]-NR6[N]-SG-NOM	қорат
қорғачын[N]-SG-NOM	қорғачын
қорту[N]-VR6[V]-IMP.2SG	қортуқ
қортуқ[N]-SG-NOM	қортуқ
қоруқ[V]-IMP.2SG	қоруқ
қоруқ[V]-NR12[N]-SG-NOM	қоруқпа
қорум[N]-SG-NOM	қорум
қос[N]-SG-NOM	қос
қос[N]-VR1[V]-IMP.2SG	қоста
қос[N]-VR2[V]-ADJR5[A]-SG-NOM	қозан
қос[N]-VR2[V]-IMP.2SG	қоза
қоста[N]-SG-NOM	қоста
қоста[N]-VR6[V]-IMP.2SG	қостақ
қош[N]-SG-NOM	қош
қош[N]-VR1[V]-ADJR5[A]-SG-NOM	қоштан
қош[N]-VR1[V]-IMP.2SG	қошта
қош[N]-VR2[V]-IMP.2SG	қожа
қош[V]-IMP.2SG	қош
қош[V]-NR1[N]-SG-NOM	қожуг
қош[V]-NR1[N]-SG-NOM	қожыг
қош[V]-NR1[N]-SG-NOM	қошқун
қош[V]-NR1[N]-SG-NOM	қошқын
қошта[ADV]	қошта
қуба[A]-SG-NOM	қуба
қуба[A]-VR3[V]-IMP.2SG	қубар
қуба[A]-VR9[V]-IMP.2SG	қубар
қуба[N]-SG-NOM	қуба
қуба[N]-VR3[V]-IMP.2SG	қубар
қубанақ[N]-SG-NOM	қубанақ
қуба-салғын[PN]-SG-NOM	қуба-салғын
қубул[V]-IMP.2SG	қубул
қуда[N]-SG-NOM	қуда
қуда[N]-VR1[V]-IMP.2SG	қудала
қуда[N]-VR6[V]-IMP.2SG	қудақ
қудағай[N]-SG-NOM	қудағай
қудай[N]-SG-NOM	қудай
қузам[N]-SG-NOM	қузам
қузуруқ[N]-ADVR[ADV]	қузуруғын
қузуруқ[N]-ATTR1[A]-SG-NOM	қузуруқтыг
қузуруқ[N]-SG-NOM	қузуруқ
қузуруқ[N]-VR1[V]-IMP.2SG	қузуруқта
қуй[N]-SG-NOM	қуй
қуй[V]-IMP.2SG	қуй
қуй[V]-NR8[N]-ADVR[ADV]	қуйағын
қуй[V]-NR8[N]-ATTR1[A]-SG-NOM	қуйақтыг
қуй[V]-NR8[N]-SG-NOM	қуйақ
қуйақ[N]-ADVR[ADV]	қуйағын
қуйақ[N]-ATTR1[A]-SG-NOM	қуйақтыг
қуйақ[N]-SG-NOM	қуйақ
қуйақ[N]-VR1[V]-IMP.2SG	қуйақта
қуйун[N]-SG-NOM	қуйун
қул[N]-SG-NOM	қул
қул[N]-VR2[V]-IMP.2SG	қула
қул[N]-VR6[V]-IMP.2SG	қулық
қулақ[N]-ATTR1[A]-SG-NOM	қулақтыг
қулақ[N]-SG-NOM	қулақ
қулақ[N]-VR1[V]-IMP.2SG	қулақта
қулаш[N]-SG-NOM	қулаш
қулун[N]-SG-NOM	қулун
қулун[N]-VR1[V]-IMP.2SG	қулунна
қум[N]-SG-NOM	қум
қумақ[N]-SG-NOM	қумақ
қумыс[N]-SG-NOM	қумыс
қунан[V]-IMP.2SG	қунан
қунан[V]-NR12[N]-SG-NOM	қунанма
қур[N]-SG-NOM	қур
қур[N]-VR2[V]-IMP.2SG	қура
қурғун[N]-SG-NOM	қурғун
қурсақ[N]-ATTR1[A]-SG-NOM	қурсақтыг
қурсақ[N]-SG-NOM	қурсақ
қурсақ[N]-VR1[V]-IMP.2SG	қурсақта
қурт[N]-SG-NOM	қурт
қуртйақ[N]-SG-NOM	қуртйақ
қуртйақ[N]-VR2[V]-IMP.2SG	қуртйаға
қуртуй[N]-SG-NOM	қуртуй
қуртуйақ[N]-SG-NOM	қуртуйақ
қуру[V]-ADJR5[A]-SG-NOM	қурун
қуру[V]-IMP.2SG	қуру
қуру[V]-NR1[N]-SG-NOM	қуруг
қуру[V]-NR1[N]-SG-NOM	қуруқун
қуру[V]-NR1[N]-SG-NOM	қуруқын
қуру[V]-NR2[N]-SG-NOM	қуруш
қуру[V]-NR5[N]-SG-NOM	қуруқ
қуру[V]-NR9[N]-SG-NOM	қурул
қуруг[A]-SG-NOM	қуруг
қурун[N]-SG-NOM	қурун
қурчан[V]-NR14[N]-SG-NOM	қурчанчық
қурчу[N]-SG-NOM	қурчу
қус[V]-IMP.2SG	қус
қус[V]-NR1[N]-ATTR1[A]-SG-NOM	қузуғлыг
қус[V]-NR1[N]-ATTR1[A]-SG-NOM	қузығлыг
қус[V]-NR1[N]-ATTR1[A]-SG-NOM	қусқунныг
қус[V]-NR1[N]-ATTR1[A]-SG-NOM	қусқынныг
қус[V]-NR1[N]-SG-NOM	қузуг
қус[V]-NR1[N]-SG-NOM	қузыг
қус[V]-NR1[N]-SG-NOM	қусқун
қус[V]-NR1[N]-SG-NOM	қусқын
қус[V]-NR3[N]-ADVR[ADV]	қусқун
қус[V]-NR3[N]-ADVR[ADV]	қусқын
қусқу[N]-ADVR[ADV]	қусқун
қусқун[N]-ATTR1[A]-SG-NOM	қусқунныг
қусқун[N]-SG-NOM	қусқун
қусқун-алып[PN]-SG-NOM	қусқун-алып
қут[N]-VR2[V]-ADJR3[A]-SG-NOM	қудағай
қут[N]-VR2[V]-IMP.2SG	қуда
қуу[N]-SG-NOM	қуу
қуу[N]-VR3[V]-IMP.2SG	қуур
қуу[N]-VR6[V]-IMP.2SG	қууқ
қуча[N]-ATTR2[A]-SG-NOM	қучағы
қуча[N]-VR6[V]-ADJR5[A]-SG-NOM	қучағын
қуча[N]-VR6[V]-IMP.2SG	қучақ
қучақ[N]-SG-NOM	қучақ
қучақ[N]-VR1[V]-ADJR5[A]-SG-NOM	қучақтан
қучақ[N]-VR1[V]-IMP.2SG	қучақта
қуш[N]-SG-NOM	қуш
қуш[N]-VR1[V]-IMP.2SG	қушта
қуш[PN]-SG-NOM	қуш
қыдай-арыг[PN]-SG-NOM	қыдай-арыг
қызыл[A]-SG-NOM	қызыл
қызыл-сибечин[PN]-SG-NOM	қызыл-сибечин
қызын[N]-SG-NOM	қызын
қызырақ[N]-SG-NOM	қызырақ
қызырақ[N]-VR1[V]-IMP.2SG	қызырақта
қый[A]-VR9[V]-IMP.2SG	қыйр
қый[N]-ADVR[ADV]	қыйын
қый[N]-ATTR2[A]-SG-NOM	қыйғы
қый[N]-SG-NOM	қый
қый[N]-VR2[V]-IMP.2SG	қыйа
қый[N]-VR6[V]-IMP.2SG	қыйық
қый[N]-VR8[V]-IMP.2SG	қыйра
қый[V]-ADJR5[A]-SG-NOM	қыйын
қый[V]-IMP.2SG	қый
қый[V]-NR3[N]-SG-NOM	қыйғы
қый[V]-NR5[N]-SG-NOM	қыйық
қый[V]-NR8[N]-SG-NOM	қыйақ
қыйал[N]-SG-NOM	қыйал
қыйал[N]-VR1[V]-IMP.2SG	қыйалла
қыйбыра[V]-ADJR5[A]-SG-NOM	қыйбыран
қыйбыра[V]-IMP.2SG	қыйбыра
қыйбыра[V]-NR2[N]-SG-NOM	қыйбыраш
қыйға[A]-SG-NOM	қыйға
қыйғы[N]-SG-NOM	қыйғы
қыйғы[N]-VR1[V]-ADJR5[A]-SG-NOM	қыйғылан
қыйғы[N]-VR1[V]-IMP.2SG	қыйғыла
қыйғы[N]-VR3[V]-IMP.2SG	қыйғыр
қыйғылық[N]-SG-NOM	қыйғылық
қыйғылық[N]-VR1[V]-IMP.2SG	қыйғылықта
қыйна[V]-IMP.2SG	қыйна
қыйна[V]-NR9[N]-SG-NOM	қыйнал
қыйын[N]-SG-NOM	қыйын
қыйын[N]-VR2[V]-IMP.2SG	қыйна
қыл[N]-ATTR1[A]-SG-NOM	қыллыг
қыл[N]-SG-NOM	қыл
қылаг[N]-VR2[V]-ADJR5[A]-SG-NOM	қылған
қылаг[N]-VR2[V]-IMP.2SG	қылға
қылыш[N]-ADVR[ADV]	қылыжын
қылыш[N]-SG-NOM	қылыш
қылыш[N]-VR1[V]-IMP.2SG	қылышта
қын[N]-SG-NOM	қын
қын[N]-VR2[V]-IMP.2SG	қына
қын[V]-IMP.2SG	қын
қыпчы[V]-IMP.2SG	қыпчы
қыпчы[V]-NR5[N]-SG-NOM	қыпчық
қыр[A]-SG-NOM	қыр
қыр[A]-VR3[V]-IMP.2SG	қырар
қыр[A]-VR3[V]-NR7[N]-SG-NOM	қырарым
қыр[N]-ADVR[ADV]	қырын
қыр[N]-AG-ADVR[ADV]	қырчын
қыр[N]-ATTR1[A]-SG-NOM	қырлыг
қыр[N]-SG-NOM	қыр
қыр[N]-VR1[V]-IMP.2SG	қырла
қыр[N]-VR2[V]-IMP.2SG	қыра
қыр[N]-VR3[V]-IMP.2SG	қырар
қыр[N]-VR6[V]-IMP.2SG	қырық
қыр[V]-ADJR5[A]-SG-NOM	қырын
қыр[V]-IMP.2SG	қыр
қыр[V]-NR12[N]-ADVR[ADV]	қырбан
қыр[V]-NR12[N]-SG-NOM	қырба
қыр[V]-NR1[N]-SG-NOM	қырқын
қыр[V]-NR1[N]-SG-NOM	қырыг
қыр[V]-NR2[N]-SG-NOM	қырыш
қыр[V]-NR5[N]-SG-NOM	қырық
қыра[N]-SG-NOM	қыра
қыра[N]-VR1[V]-IMP.2SG	қырла
қыра[N]-VR2[V]-IMP.2SG	қыраа
қыра[N]-VR6[V]-IMP.2SG	қырақ
қыраа[N]-SG-NOM	қыраа
қырба[N]-ADVR[ADV]	қырбан
қырба[N]-SG-NOM	қырба
қырған-қылыш[PN]-SG-NOM	қырған-қылыш
қырлық[N]-SG-NOM	қырлық
қыр-ӧлең[PN]-SG-NOM	қыр-ӧлең
қыр-ӧрекен[PN]-SG-NOM	қыр-ӧрекен
қыр-ӧреккен[PN]-SG-NOM	қыр-ӧреккен
қыртыш[N]-VR1[V]-IMP.2SG	қыртышта
қырық[NUM]-NOM	қырық
қыс[N]-ADVR[ADV]	қызын
қыс[N]-ATTR1[A]-SG-NOM	қыстыг
қыс[N]-ATTR2[A]-SG-NOM	қысқы
қыс[N]-SG-NOM	қыс
қыс[N]-VR1[V]-ADJR5[A]-SG-NOM	қыстан
қыс[N]-VR1[V]-IMP.2SG	қыста
қыс[N]-VR2[V]-IMP.2SG	қыза
қыс[N]-VR3[V]-IMP.2SG	қызар
қыс[V]-ADJR5[A]-SG-NOM	қызын
қыс[V]-IMP.2SG	қыс
қыс[V]-NR11[N]-SG-NOM	қыспақ
қыс[V]-NR12[N]-SG-NOM	қыспа
қыс[V]-NR13[N]-SG-NOM	қысчақ
қыс[V]-NR3[N]-SG-NOM	қысқы
қыс[V]-NR7[N]-ADVR[ADV]	қызымын
қыс[V]-NR7[N]-SG-NOM	қызым
қыс-алып[PN]-SG-NOM	қыс-алып
қысйақ[N]-ADVR[ADV]	қысйағын
қысйақ[N]-SG-NOM	қысйақ
қысйақ[N]-VR2[V]-IMP.2SG	қысйаға
қысқа[A]-SG-NOM	қысқа
қысқы[N]-SG-NOM	қысқы
қысқы[N]-VR3[V]-IMP.2SG	қысқыр
қыста[V]-ADJR5[A]-SG-NOM	қыстан
қыста[V]-IMP.2SG	қыста
қыста[V]-NR2[N]-SG-NOM	қысташ
қычан[V]-IMP.2SG	қычан
қычы[V]-IMP.2SG	қычы
қычы[V]-NR5[N]-SG-NOM	қычық
қыш[N]-ATTR2[A]-SG-NOM	қышқы
қыш[N]-SG-NOM	қыш
қышқы[A]-SG-NOM	қышқы
қышқы[N]-SG-NOM	қышқы
қыыр[V]-IMP.2SG	қыыр
ла[PART]	ла
лапке[N]-SG-NOM	лапке
лапке[N]-VR1[V]-IMP.2SG	лапкеле
ле[PART]	ле
леш-тай[PN]-SG-NOM	леш-тай
ма[PART]	ма
маас[N]-SG-NOM	маас
маас[N]-VR1[V]-IMP.2SG	мааста
мағат[ADV]	мағат
май[ADV]	май
маққыш[N]-SG-NOM	маққыш
мал[N]-ADVR[ADV]	малын
мал[N]-ATTR1[A]-SG-NOM	маллыг
мал[N]-SG-NOM	мал
мал[N]-VR1[V]-IMP.2SG	малла
малта[N]-SG-NOM	малта
малта[N]-VR1[V]-IMP.2SG	малтала
маң[N]-VR1[V]-IMP.2SG	маңна
маң[N]-VR5[V]-IMP.2SG	маңзыра
маң[N]-VR8[V]-IMP.2SG	маңра
маңзыра[V]-IMP.2SG	маңзыра
маңзыра[V]-NR1[N]-ATTR1[A]-SG-NOM	маңзырағлыг
маңзыра[V]-NR1[N]-ATTR1[A]-SG-NOM	маңзырақынныг
маңнан[V]-IMP.2SG	маңнан
марс[N]-SG-NOM	марс
марс[N]-VR1[V]-IMP.2SG	марста
мас[N]-SG-NOM	мас
мас[N]-VR1[V]-ADJR5[A]-SG-NOM	мастан
мас[N]-VR1[V]-IMP.2SG	маста
масқа[N]-SG-NOM	масқа
маттап[ADV]	маттап
ме[PART]	ме
мекке[N]-ATTR1[A]-SG-NOM	меккелиг
мекке[N]-SG-NOM	мекке
мекке[N]-VR1[V]-IMP.2SG	меккеле
менчи[N]-SG-NOM	менчи
менчи[N]-VR1[V]-IMP.2SG	менчиле
менчи[N]-VR4[V]-IMP.2SG	менчисин
мерген[N]-ATTR1[A]-SG-NOM	мергенниг
мерген[N]-SG-NOM	мерген
мерген[N]-VR1[V]-IMP.2SG	мергенне
мерет-оолақ[PN]-SG-NOM	мерет-оолақ
мериг[N]-SG-NOM	мериг
мин[N]-SG-NOM	мин
мин[N]-VR2[V]-IMP.2SG	мине
мине[INTJ]	мине
мичик[N]-SG-NOM	мичик
моға[V]-IMP.2SG	моға
мӧзӱк[N]-SG-NOM	мӧзӱк
мойду[N]-SG-NOM	мойду
мойду[N]-VR1[V]-IMP.2SG	мойдула
мойну[N]-ADVR[ADV]	мойнун
мойну[N]-SG-NOM	мойну
мӧке[N]-SG-NOM	мӧке
мӧкӧ[N]-SG-NOM	мӧкӧ
молат[N]-SG-NOM	молат
молат[N]-VR1[V]-IMP.2SG	молатта
мӧңе[N]-SG-NOM	мӧңе
мӧңӱс[A]-SG-NOM	мӧңӱс
моос[N]-SG-NOM	моос
моос[N]-VR1[V]-IMP.2SG	мооста
мӱн[N]-SG-NOM	мӱн
мӱн[V]-IMP.2SG	мӱн
мӱндӱр[N]-SG-NOM	мӱндӱр
мунчуқ[N]-SG-NOM	мунчуқ
муң[NUM]-DAT	муңа
муң[NUM]-DAT	муңға
муң[NUM]-NOM	муң
мус[N]-SG-NOM	мус
мӱӱн[V]-IMP.2SG	мӱӱн
мӱӱс[N]-ATTR1[A]-SG-NOM	мӱӱстиг
мӱӱс[N]-SG-NOM	мӱӱс
мылтық[N]-SG-NOM	мылтық
мырчақ[N]-SG-NOM	мырчақ
на[PART]	на
наа[A]-SG-NOM	наа
наа[A]-VR3[V]-IMP.2SG	наар
наа[A]-VR9[V]-IMP.2SG	наар
наақ[N]-ADVR[ADV]	наағын
наақ[N]-ATTR1[A]-SG-NOM	наақтыг
наақ[N]-SG-NOM	наақ
наал[V]-IMP.2SG	наал
наара[PSTP]	наара
наг[N]-VR2[V]-ADJR5[A]-SG-NOM	наған
наг[N]-VR2[V]-IMP.2SG	наға
нағбур[N]-SG-NOM	нағбур
най[N]-SG-NOM	най
нал[V]-IMP.2SG	нал
нан[N]-ADVR[ADV]	нанын
нан[N]-AG-ATTR1[A]-SG-NOM	нанчылыг
нан[N]-AG-VR1[V]-IMP.2SG	нанчыла
нан[N]-SG-NOM	нан
нан[N]-VR2[V]-IMP.2SG	нана
нан[N]-VR3[V]-ADJR5[A]-SG-NOM	нанарын
нан[N]-VR3[V]-IMP.2SG	нанар
нан[V]-ADJR2[A]-SG-NOM	нанчы
нан[V]-ADJR3[A]-SG-NOM	нанғай
нан[V]-ADJR5[A]-SG-NOM	нанын
нан[V]-IMP.2SG	нан
нан[V]-NR12[N]-SG-NOM	нанма
нан[V]-NR2[N]-ATTR1[A]-SG-NOM	наныштыг
нан[V]-NR2[N]-SG-NOM	наныш
нанчы[N]-ATTR1[A]-SG-NOM	нанчылыг
нанчы[N]-SG-NOM	нанчы
нанчы[N]-VR1[V]-IMP.2SG	нанчыла
не[PART]	не
небе[N]-SG-NOM	небе
небе[N]-VR1[V]-IMP.2SG	небеле
нег[N]-SG-NOM	нег
нег[N]-VR7[V]-IMP.2SG	негер
нег[V]-IMP.2SG	нег
негеечи[N]-SG-NOM	негеечи
негечи[N]-SG-NOM	негечи
недле[N]-SG-NOM	недле
нек[N]-SG-NOM	нек
нем[PART]	нем
неме[N]-SG-NOM	неме
ниик[A]-SG-NOM	ниик
ниик[N]-SG-NOM	ниик
нин[N]-SG-NOM	нин
нитке[N]-SG-NOM	нитке
но[PART]	но
ной[V]-IMP.2SG	ной
ной[V]-NR2[N]-SG-NOM	нойуш
ной[V]-NR2[N]-SG-NOM	нойыш
ноо[PART]	ноо
ныбақ[N]-SG-NOM	ныбақ
ныбақ[N]-VR1[V]-IMP.2SG	ныбақта
ныбырт[N]-SG-NOM	ныбырт
ныбыртқа[N]-SG-NOM	ныбыртқа
ныбыртқа[N]-VR1[V]-IMP.2SG	ныбыртқала
ныңнақ[A]-SG-NOM	ныңнақ
нырсла[V]-NR5[N]-SG-NOM	нырслақ
нырслақ[N]-SG-NOM	нырслақ
обаг[N]-SG-NOM	обаг
обаг[N]-VR2[V]-IMP.2SG	обаға
обал[N]-ATTR1[A]-SG-NOM	обаллыг
обал[N]-SG-NOM	обал
оғлан[N]-SG-NOM	оғлан
оғлу[N]-ADVR[ADV]	оғлун
оғлу[N]-SG-NOM	оғлу
оғыл[N]-SG-NOM	оғыл
ода[V]-ADJR5[A]-SG-NOM	одан
ода[V]-IMP.2SG	ода
ода[V]-NR1[N]-ATTR1[A]-SG-NOM	одағлыг
ода[V]-NR1[N]-ATTR1[A]-SG-NOM	одақынныг
ода[V]-NR1[N]-SG-NOM	одаг
ода[V]-NR1[N]-SG-NOM	одақын
ода[V]-NR5[N]-SG-NOM	одақ
одаг[N]-ATTR1[A]-SG-NOM	одағлыг
одаг[N]-SG-NOM	одаг
одаг[N]-VR2[V]-IMP.2SG	одаға
одаң[N]-SG-NOM	одаң
одаң[N]-VR1[V]-IMP.2SG	одаңна
одаң[N]-VR2[V]-IMP.2SG	одаңа
ӧдӱк[N]-ATTR1[A]-SG-NOM	ӧдӱктиг
ӧдӱк[N]-SG-NOM	ӧдӱк
одуң[N]-SG-NOM	одуң
одуң[N]-VR1[V]-IMP.2SG	одуңна
одуң[N]-VR2[V]-IMP.2SG	одуңа
одур[V]-ADJR2[A]-SG-NOM	одурчу
одур[V]-ADJR2[A]-SG-NOM	одурчы
одур[V]-ADJR3[A]-SG-NOM	одурғай
одур[V]-IMP.2SG	одур
ӧдӱр[V]-IMP.2SG	ӧдӱр
ӧдӱр[V]-NR12[N]-SG-NOM	ӧдӱрбе
ӧдӱр[V]-NR2[N]-SG-NOM	ӧдӱриш
одур[V]-NR2[N]-SG-NOM	одуруш
ӧдӱр[V]-NR2[N]-SG-NOM	ӧдӱрӱш
одур[V]-NR2[N]-SG-NOM	одурыш
одус[NUM]-NOM	одус
ӧдӱш[N]-ATTR1[A]-SG-NOM	ӧдӱштиг
ӧдӱш[N]-SG-NOM	ӧдӱш
ой[N]-ADVR[ADV]	ойын
ой[N]-SG-NOM	ой
ой[N]-VR1[V]-IMP.2SG	ойла
ой[N]-VR2[V]-IMP.2SG	ойа
ойа[V]-IMP.2SG	ойа
ойас[N]-SG-NOM	ойас
ойас[N]-VR1[V]-IMP.2SG	ойаста
ойуқ[N]-SG-NOM	ойуқ
ойун[N]-SG-NOM	ойун
ойун[N]-VR2[V]-IMP.2SG	ойна
ӧкпе[N]-SG-NOM	ӧкпе
ӧксӱс[N]-SG-NOM	ӧксӱс
оқ[N]-ADVR[ADV]	оғын
оқ[N]-SG-NOM	оқ
оқ[N]-VR1[V]-IMP.2SG	оқта
оқ[N]-VR2[V]-ADJR5[A]-SG-NOM	оған
оқча[N]-SG-NOM	оқча
ӧл[A]-SG-NOM	ӧл
ӧл[A]-VR3[V]-IMP.2SG	ӧлер
ӧл[A]-VR3[V]-NR7[N]-SG-NOM	ӧлерим
ӧл[V]-IMP.2SG	ӧл
ӧл[V]-NR1[N]-SG-NOM	ӧлиг
ӧл[V]-NR1[N]-SG-NOM	ӧлқин
ӧл[V]-NR1[N]-SG-NOM	ӧлқӱн
ӧл[V]-NR1[N]-SG-NOM	ӧлӱг
ӧл[V]-NR2[N]-SG-NOM	ӧлиш
ӧл[V]-NR2[N]-SG-NOM	ӧлӱш
олақ[N]-SG-NOM	олақ
ӧлең[N]-SG-NOM	ӧлең
ӧлең[N]-VR1[V]-IMP.2SG	ӧлеңне
омаш[N]-ADVR[ADV]	омажын
омаш[N]-SG-NOM	омаш
ӧн[N]-SG-NOM	ӧн
он[NUM]-NOM	он
он[NUM]-POSS.2SG-NOM	оның
он[NUM]-POSS.3SG-NOM-PRED.2SG	оның
он[NUM]-POSS.3SG-NOM	оны
ӧн[V]-IMP.2SG	ӧн
оно[PART]	оно
оң[N]-SG-NOM	оң
оң[N]-VR1[V]-IMP.2SG	оңна
оң[V]-IMP.2SG	оң
оо[N]-SG-NOM	оо
оо[N]-VR1[V]-IMP.2SG	оола
оо[N]-VR3[V]-IMP.2SG	оор
оода[V]-IMP.2SG	оода
оол[N]-SG-NOM	оол
оол[N]-VR1[V]-IMP.2SG	оолла
оол[N]-VR2[V]-IMP.2SG	оола
оола[V]-IMP.2SG	оола
оола[V]-NR1[N]-SG-NOM	оолаг
оола[V]-NR1[N]-SG-NOM	оолақын
оола[V]-NR2[N]-SG-NOM	оолаш
оола[V]-NR3[N]-SG-NOM	оолағы
оола[V]-NR5[N]-SG-NOM	оолақ
ӧӧр[N]-SG-NOM	ӧӧр
оорла[V]-IMP.2SG	оорла
оорла[V]-NR1[N]-SG-NOM	оорлаг
оорла[V]-NR1[N]-SG-NOM	оорлақын
оорла[V]-NR2[N]-SG-NOM	оорлаш
оорта[V]-IMP.2SG	оорта
оорта[V]-NR6[N]-SG-NOM	оортат
ор[N]-SG-NOM	ор
ор[N]-VR1[V]-IMP.2SG	орла
ор[N]-VR2[V]-ADJR5[A]-SG-NOM	оран
ор[N]-VR2[V]-IMP.2SG	ора
ӧр[V]-ADJR5[A]-SG-NOM	ӧрин
ор[V]-ADJR5[A]-SG-NOM	орын
ор[V]-IMP.2SG	ор
ӧр[V]-IMP.2SG	ӧр
ор[V]-NR3[N]-SG-NOM	орғу
ор[V]-NR3[N]-SG-NOM	орғы
ор[V]-NR8[N]-SG-NOM	орақ
ор[V]-NR9[N]-SG-NOM	орл
ора[N]-ADVR[ADV]	оран
ора[N]-SG-NOM	ора
ора[N]-VR1[V]-IMP.2SG	орла
ора[N]-VR6[V]-IMP.2SG	орақ
ора[V]-ADJR5[A]-SG-NOM	оран
ора[V]-IMP.2SG	ора
ора[V]-NR5[N]-SG-NOM	орақ
ора[V]-NR6[N]-SG-NOM	орат
ора[V]-NR7[N]-SG-NOM	орам
ора[V]-NR9[N]-SG-NOM	орал
орақ[N]-SG-NOM	орақ
орам[N]-SG-NOM	орам
ӧрге[N]-SG-LOC-ATTR4[A]-SG-NOM	ӧргедеги
ӧрге[N]-SG-NOM	ӧрге
ӧрге[N]-VR1[V]-IMP.2SG	ӧргеле
ӧрге[N]-VR2[V]-IMP.2SG	ӧргее
ӧрге[N]-VR6[V]-IMP.2SG	ӧргеқ
ӧрген[N]-SG-NOM	ӧрген
ӧре[ADV]-ATTR2[A]-SG-NOM	ӧреги
ӧре[ADV]	ӧре
ӧре[N]-ATTR2[A]-SG-NOM	ӧреги
ӧре[N]-SG-NOM	ӧре
ӧре[N]-VR1[V]-IMP.2SG	ӧрле
ӧре[N]-VR3[V]-IMP.2SG	ӧрер
ӧрекен[N]-SG-NOM	ӧрекен
ӧрекен[N]-VR1[V]-IMP.2SG	ӧрекенне
ӧреккен[N]-SG-NOM	ӧреккен
орна[V]-IMP.2SG	орна
ӧрӧкӧ[N]-ADVR[ADV]	ӧрӧкӧн
ӧрт[N]-SG-NOM	ӧрт
ӧрт[N]-VR2[V]-IMP.2SG	ӧрте
орта[N]-SG-LOC-ATTR4[A]-SG-NOM	ортадағы
орта[N]-SG-NOM	орта
орта[N]-VR6[V]-IMP.2SG	ортақ
ӧрӱн[N]-SG-NOM	ӧрӱн
ӧрӱн[V]-IMP.2SG	ӧрӱн
оруң[N]-SG-NOM	оруң
оруң[N]-VR1[V]-IMP.2SG	оруңна
орын[N]-SG-NOM	орын
орын[N]-VR2[V]-IMP.2SG	орна
ӧс[N]-SG-NOM	ӧс
ӧс[N]-VR1[V]-IMP.2SG	ӧсте
ӧс[N]-VR2[V]-IMP.2SG	ӧзе
ӧс[N]-VR3[V]-IMP.2SG	ӧзер
ӧс[N]-VR4[V]-IMP.2SG	ӧссин
ӧс[N]-VR4[V]-IMP.2SG	ӧссӱн
ос[V]-IMP.2SG	ос
ӧс[V]-IMP.2SG	ӧс
ӧс[V]-NR2[N]-SG-NOM	ӧзиш
ӧс[V]-NR2[N]-SG-NOM	ӧзӱш
ӧске[A]-SG-NOM	ӧске
ӧсте[V]-IMP.2SG	ӧсте
ӧсте[V]-NR12[N]-SG-NOM	ӧстебе
ӧсте[V]-NR2[N]-SG-NOM	ӧстеш
от[N]-SG-NOM	от
ӧт[N]-SG-NOM	ӧт
от[N]-VR1[V]-IMP.2SG	отта
от[N]-VR2[V]-ADJR5[A]-SG-NOM	одан
от[N]-VR2[V]-IMP.2SG	ода
ӧт[N]-VR2[V]-IMP.2SG	ӧде
ӧт[V]-IMP.2SG	ӧт
ӧт[V]-NR2[N]-ATTR1[A]-SG-NOM	ӧдиштиг
ӧт[V]-NR2[N]-ATTR1[A]-SG-NOM	ӧдӱштиг
ӧт[V]-NR2[N]-SG-NOM	ӧдиш
ӧт[V]-NR2[N]-SG-NOM	ӧдӱш
отуқ[N]-SG-NOM	отуқ
очу[N]-SG-NOM	очу
очу[N]-VR6[V]-IMP.2SG	очуқ
очы[N]-SG-NOM	очы
ӧш[N]-ADVR[ADV]	ӧжин
ош[N]-SG-NOM	ош
ӧш[N]-SG-NOM	ӧш
ӧш[N]-VR1[V]-IMP.2SG	ӧште
ошқаш[PSTP]	ошқаш
ӧштӱ[N]-SG-NOM	ӧштӱ
ӧштӱ[N]-VR1[V]-IMP.2SG	ӧштӱле
па[PART]	па
паа[N]-SG-NOM	паа
паа[N]-VR3[V]-ADJR5[A]-SG-NOM	паарын
паар[N]-ATTR1[A]-SG-NOM	паарлыг
паар[N]-SG-NOM	паар
паар[N]-VR1[V]-ADJR5[A]-SG-NOM	паарлан
паар[N]-VR1[V]-IMP.2SG	паарла
паат[N]-SG-NOM	паат
паг[N]-SG-NOM	паг
паг[N]-VR1[V]-IMP.2SG	пағла
пағры[N]-SG-NOM	пағры
падырбаш[N]-SG-NOM	падырбаш
пажа[V]-IMP.2SG	пажа
пажа[V]-NR6[N]-SG-NOM	пажат
пажында[PSTP]	пажында
пазоқ[ADV]	пазоқ
пай[A]-SG-NOM	пай
пай[N]-SG-NOM	пай
пай[N]-VR1[V]-IMP.2SG	пайла
пай[N]-VR2[V]-ADJR5[A]-SG-NOM	пайан
пай[N]-VR2[V]-IMP.2SG	пайа
пайа[ADV]-ATTR2[A]-SG-NOM	пайағы
пайа[ADV]	пайа
пайба[N]-SG-NOM	пайба
пай-пай[INTJ]	пай-пай
пақ[N]-SG-NOM	пақ
пақ[N]-VR1[V]-ADJR5[A]-SG-NOM	пақтан
пақ[N]-VR1[V]-IMP.2SG	пақта
пақ[V]-IMP.2SG	пақ
пал[N]-SG-NOM	пал
пал[N]-VR1[V]-IMP.2SG	палла
пал[N]-VR2[V]-IMP.2SG	пала
пал[N]-VR6[V]-IMP.2SG	палық
пала[N]-ATTR1[A]-SG-NOM	палалыг
пала[N]-SG-NOM	пала
пала[N]-VR1[V]-IMP.2SG	палла
пала[N]-VR6[V]-IMP.2SG	палақ
палғаш[N]-SG-NOM	палғаш
палке[N]-SG-NOM	палке
палке[N]-VR1[V]-IMP.2SG	палкеле
палыг[N]-SG-NOM	палыг
палыг[N]-VR2[V]-IMP.2SG	палға
палық[N]-SG-NOM	палық
пар[V]-ADJR2[A]-SG-NOM	парчы
пар[V]-ADJR3[A]-SG-NOM	парғай
пар[V]-IMP.2SG	пар
пар[V]-NR12[N]-SG-NOM	парба
пар[V]-NR9[N]-SG-NOM	парл
пара[N]-SG-NOM	пара
пара[N]-VR1[V]-IMP.2SG	парла
пара[N]-VR2[V]-ADJR5[A]-SG-NOM	параан
пара[N]-VR2[V]-IMP.2SG	параа
пара[N]-VR3[V]-ADJR5[A]-SG-NOM	парарын
пара[N]-VR3[V]-IMP.2SG	парар
пара[N]-VR6[V]-IMP.2SG	парақ
параан[N]-SG-NOM	параан
парата[N]-SG-NOM	парата
парс[N]-SG-NOM	парс
пары[N]-SG-NOM	пары
пары[N]-VR1[V]-IMP.2SG	парла
пас[N]-ADVR[ADV]	пазын
пас[N]-SG-NOM	пас
пас[N]-VR2[V]-IMP.2SG	паза
пас[N]-VR3[V]-IMP.2SG	пазар
пас[N]-VR4[V]-IMP.2SG	пассын
пас[V]-ADJR5[A]-SG-NOM	пазын
пас[V]-IMP.2SG	пас
пас[V]-NR12[N]-SG-NOM	паспа
пас[V]-NR2[N]-SG-NOM	пазыш
пас[V]-NR4[N]-SG-NOM	пасқыш
пас[V]-NR6[N]-SG-NOM	пазыт
пас[V]-NR8[N]-SG-NOM	пазақ
пат[V]-IMP.2SG	пат
пат[V]-NR1[N]-SG-NOM	падыг
пат[V]-NR1[N]-SG-NOM	патқын
паш[N]-ADVR[ADV]	пажын
паш[N]-ATTR1[A]-SG-NOM	паштыг
паш[N]-ATTR2[A]-SG-NOM	пашқы
паш[N]-SG-NOM	паш
паш[N]-VR1[V]-IMP.2SG	пашта
паш[N]-VR2[V]-IMP.2SG	пажа
паш[V]-ADJR5[A]-SG-NOM	пажын
паш[V]-IMP.2SG	паш
паш[V]-NR3[N]-SG-NOM	пашқы
паш[V]-NR7[N]-SG-NOM	пажым
пашқа[A]-SG-NOM	пашқа
пе[PART]	пе
пег[N]-SG-NOM	пег
педре[N]-SG-NOM	педре
пееде[ADV]	пееде
пеере[ADV]	пеере
пеере[PSTP]	пеере
пежик[N]-SG-NOM	пежик
пежик[N]-VR1[V]-IMP.2SG	пежикте
пей[N]-SG-NOM	пей
пей[N]-VR1[V]-IMP.2SG	пейле
пек[N]-VR1[V]-ADJR5[A]-SG-NOM	пектен
пек[N]-VR1[V]-IMP.2SG	пекте
пел[N]-ADVR[ADV]	пелин
пел[N]-SG-NOM	пел
пел[N]-VR1[V]-IMP.2SG	пелле
пел[N]-VR2[V]-ADJR5[A]-SG-NOM	пелен
пел[N]-VR2[V]-IMP.2SG	пеле
пелен[A]-SG-NOM	пелен
пелтир[N]-SG-NOM	пелтир
пер[V]-ADJR2[A]-SG-NOM	перчи
пер[V]-IMP.2SG	пер
пер[V]-NR12[N]-SG-NOM	пербе
пер[V]-NR2[N]-SG-NOM	периш
перек[N]-SG-NOM	перек
пес[N]-SG-NOM	пес
пече[N]-ATTR1[A]-SG-NOM	печелиг
пече[N]-SG-NOM	пече
пеш[NUM]-NOM	пеш
пеш[NUM]-POSS.3SG-ACC	пежин
пий[N]-SG-NOM	пий
пий[N]-VR1[V]-IMP.2SG	пийле
пил[V]-ADJR5[A]-SG-NOM	пилин
пил[V]-IMP.2SG	пил
пил[V]-NR2[N]-SG-NOM	пилиш
пилек[N]-SG-NOM	пилек
пилек[N]-VR1[V]-ADJR5[A]-SG-NOM	пилектен
пилек[N]-VR1[V]-IMP.2SG	пилекте
пир[NUM]-DAT=EMP1	пирғоқ
пир[NUM]-DAT	пирге
пир[NUM]-INST-PRED.2SG	пирбең
пир[NUM]-INST-PRED.2SG	пирбилең
пир[NUM]-INST	пирбе
пир[NUM]-INST	пирбиле
пир[NUM]-NOM1	+?
пир[NUM]-NOM	пир
пирси[NUM]-NOM1	+?
пирси[NUM]-NOM-PRED.1PL	пирсибис
пирси[NUM]-NOM	пирси
пирси[NUM]-POSS.1PL-NOM	пирсибис
пис[N]-ATTR1[A]-SG-NOM	пистиг
пис[N]-SG-NOM	пис
пис[N]-VR1[V]-IMP.2SG	писте
пичен[N]-SG-NOM	пичен
пичен[N]-VR1[V]-IMP.2SG	пиченне
пичик[N]-SG-NOM	пичик
плат[N]-SG-NOM	плат
пӧгӱн[V]-IMP.2SG	пӧгӱн
позаға[N]-SG-NOM	позаға
позаға[N]-VR6[V]-IMP.2SG	позағақ
пол[V]-ADJR2[A]-SG-NOM	полчу
пол[V]-ADJR2[A]-SG-NOM	полчы
пол[V]-ADJR3[A]-SG-NOM	полғай
пол[V]-ADJR5[A]-SG-NOM	полын
пол[V]-IMP.2SG	пол
пӧл[V]-IMP.2SG	пӧл
пол[V]-NR11[N]-SG-NOM	полбақ
пол[V]-NR12[N]-SG-NOM	полба
пӧл[V]-NR2[N]-SG-NOM	пӧлиш
пол[V]-NR2[N]-SG-NOM	полуш
пӧл[V]-NR2[N]-SG-NOM	пӧлӱш
пол[V]-NR2[N]-SG-NOM	полыш
пӧле[N]-SG-NOM	пӧле
пӧлен[V]-IMP.2SG	пӧлен
пом[N]-SG-NOM	пом
пор[N]-SG-NOM	пор
пор[N]-VR2[V]-ADJR5[A]-SG-NOM	поран
пор[N]-VR2[V]-IMP.2SG	пора
поран[N]-SG-NOM	поран
порас[N]-SG-NOM	порас
порас-арыг[PN]-SG-NOM	порас-арыг
порат[N]-ADVR[ADV]	порадын
порат[N]-ATTR1[A]-SG-NOM	пораттыг
порат[N]-SG-NOM	порат
порат[N]-VR1[V]-IMP.2SG	поратта
порос[N]-SG-NOM	порос
пӧрӱ[N]-ATTR2[A]-SG-NOM	пӧрӱги
пӧрӱ[N]-SG-NOM	пӧрӱ
пӧрӱк[N]-ATTR1[A]-SG-NOM	пӧрӱктиг
пӧрӱк[N]-SG-NOM	пӧрӱк
пос-тайға[PN]-SG-NOM	пос-тайға
пош[A]-SG-NOM	пош
пош[A]-VR3[V]-IMP.2SG	пожар
пош[N]-ATTR1[A]-SG-NOM	поштыг
пош[N]-SG-NOM	пош
пош[N]-VR2[V]-ADJR5[A]-SG-NOM	пожан
пош[N]-VR2[V]-IMP.2SG	пожа
пош[N]-VR3[V]-IMP.2SG	пожар
пош[V]-IMP.2SG	пош
престек[N]-SG-NOM	престек
пуға[N]-SG-NOM	пуға
пуға[N]-VR6[V]-IMP.2SG	пуғақ
пуғул[N]-SG-NOM	пуғул
пӱдӱр[V]-IMP.2SG	пӱдӱр
пӱдӱрге[N]-ADVR[ADV]	пӱдӱрген
пузуқ[N]-SG-NOM	пузуқ
пӱк[N]-SG-NOM	пӱк
пӱк[N]-VR1[V]-IMP.2SG	пӱкте
пӱк[V]-IMP.2SG	пӱк
пула[V]-ADJR5[A]-SG-NOM	пулан
пула[V]-IMP.2SG	пула
пулан[N]-SG-NOM	пулан
пулға[V]-IMP.2SG	пулға
пулға[V]-NR6[N]-SG-NOM	пулғат
пулуң[N]-SG-NOM	пулуң
пулуң[N]-VR1[V]-IMP.2SG	пулуңна
пулут[N]-SG-NOM	пулут
пулут[N]-VR1[V]-IMP.2SG	пулутта
пӱр[N]-ATTR1[A]-SG-NOM	пӱрлиг
пӱр[N]-SG-NOM	пӱр
пӱр[N]-VR1[V]-IMP.2SG	пӱрле
пӱр[N]-VR2[V]-IMP.2SG	пӱре
пур[V]-IMP.2SG	пур
пур[V]-NR12[N]-SG-NOM	пурба
пур[V]-NR2[N]-SG-NOM	пуруш
пур[V]-NR2[N]-SG-NOM	пурыш
пур[V]-NR5[N]-SG-NOM	пуруқ
пур[V]-NR5[N]-SG-NOM	пурық
пӱрге[V]-IMP.2SG	пӱрге
пурлуқ[V]-IMP.2SG	пурлуқ
пурна[V]-IMP.2SG	пурна
пурна[V]-NR1[N]-SG-NOM	пурнаг
пурна[V]-NR1[N]-SG-NOM	пурнақын
пурну[N]-ADVR[ADV]	пурнун
пурну[N]-SG-NOM	пурну
пурну[N]-VR1[V]-IMP.2SG	пурнула
пуруқ[V]-IMP.2SG	пуруқ
пурун[N]-SG-LOC-ATTR4[A]-SG-NOM	пурундағы
пурун[N]-SG-NOM	пурун
пурун[N]-VR2[V]-IMP.2SG	пурна
пус[N]-SG-NOM	пус
пус[N]-VR1[V]-ADJR5[A]-SG-NOM	пустан
пус[N]-VR1[V]-IMP.2SG	пуста
пут[N]-SG-NOM	пут
пут[N]-VR1[V]-IMP.2SG	путта
пӱт[V]-IMP.2SG	пӱт
пӱт[V]-NR2[N]-SG-NOM	пӱдиш
пӱт[V]-NR2[N]-SG-NOM	пӱдӱш
пыр[V]-ADJR5[A]-SG-NOM	пырын
пыр[V]-IMP.2SG	пыр
пыр[V]-NR3[N]-SG-NOM	пырғы
пыр[V]-NR9[N]-SG-NOM	пырл
пырғы[N]-SG-NOM	пырғы
пырғы[N]-VR3[V]-IMP.2SG	пырғыр
пырын[N]-SG-NOM	пырын
пычақ[N]-SG-NOM	пычақ
пыш[V]-ADJR1[A]-SG-NOM	пышқақ
пыш[V]-ADJR5[A]-SG-NOM	пыжын
пыш[V]-IMP.2SG	пыш
пыш[V]-NR1[N]-ADVR[ADV]	пыжығын
пыш[V]-NR1[N]-ADVR[ADV]	пышқынын
пыш[V]-NR1[N]-SG-NOM	пыжыг
пыш[V]-NR1[N]-SG-NOM	пышқын
пыш[V]-NR5[N]-ADVR[ADV]	пыжығын
пыш[V]-NR5[N]-SG-NOM	пыжық
пышқы[N]-VR3[V]-IMP.2SG	пышқыр
пышқыр[V]-IMP.2SG	пышқыр
пышқыр[V]-NR2[N]-SG-NOM	пышқырыш
рақ[A]-SG-NOM	рақ
саада[V]-NR5[N]-SG-NOM	саадақ
саадақ[N]-SG-NOM	саадақ
саақ[N]-SG-NOM	саақ
саақ[N]-VR2[V]-IMP.2SG	сааға
саара[PSTP]	саара
саат[N]-SG-NOM	саат
сабақ[N]-SG-NOM	сабақ
сабын[N]-SG-NOM	сабын
сабыр[V]-IMP.2SG	сабыр
саг[V]-ADJR5[A]-SG-NOM	сағын
саг[V]-IMP.2SG	саг
саг[V]-NR2[N]-ADVR[ADV]	сағыжын
саг[V]-NR2[N]-ATTR1[A]-SG-NOM	сағыштыг
саг[V]-NR2[N]-SG-NOM	сағыш
сағал[N]-ADVR[ADV]	сағалын
сағал[N]-SG-NOM	сағал
сағры[N]-ATTR1[A]-SG-NOM	сағрылыг
сағры[N]-SG-NOM	сағры
сағры[N]-VR1[V]-ADJR5[A]-SG-NOM	сағрылан
сағры[N]-VR1[V]-IMP.2SG	сағрыла
сағын[V]-IMP.2SG	сағын
сағыры[N]-VR6[V]-IMP.2SG	сағырық
сағыш[N]-ADVR[ADV]	сағыжын
сағыш[N]-ATTR1[A]-SG-NOM	сағыштыг
сағыш[N]-SG-NOM	сағыш
сай[N]-ADVR[ADV]	сайын
сай[N]-SG-NOM	сай
сай[N]-VR1[V]-IMP.2SG	сайла
сай[N]-VR2[V]-ADJR2[A]-SG-NOM	сайачы
сай[N]-VR2[V]-IMP.2SG	сайа
сайа[PSTP]	сайа
сайа[V]-ADJR2[A]-SG-NOM	сайачы
сайа[V]-IMP.2SG	сайа
сайа[V]-NR6[N]-SG-NOM	сайат
сайатчы-қан[PN]-SG-NOM	сайатчы-қан
сайачы-қан[PN]-SG-NOM	сайачы-қан
сай-қан[PN]-SG-NOM	сай-қан
сайын[PSTP]	сайын
сақ[A]-SG-NOM	сақ
сақ[N]-ADVR[ADV]	сағын
сақ[N]-SG-NOM	сақ
сақ[N]-VR1[V]-ADJR3[A]-SG-NOM	сақтағай
сақ[N]-VR1[V]-IMP.2SG	сақта
сақ[N]-VR2[V]-IMP.2SG	саға
сал[N]-ADVR[ADV]	салын
сал[N]-ATTR2[A]-SG-NOM	салғы
сал[N]-SG-NOM	сал
сал[N]-VR2[V]-IMP.2SG	сала
сал[N]-VR2[V]-PASS-FUT[PTCP]-SG-POSS.3SG-LOC-ATTR4[A]-SG-NOM	салаларындағы
сал[N]-VR3[V]-IMP.2SG	салар
сал[V]-ADJR3[A]-SG-NOM	салғай
сал[V]-ADJR5[A]-SG-NOM	салын
сал[V]-IMP.2SG	сал
сал[V]-NR12[N]-SG-NOM	салба
сал[V]-NR2[N]-SG-NOM	салыш
сал[V]-NR3[N]-ADVR[ADV]	салғын
сал[V]-NR3[N]-SG-NOM	салғы
сала[N]-SG-NOM	сала
сала[N]-VR2[V]-IMP.2SG	салаа
сала[N]-VR3[V]-IMP.2SG	салар
сала[N]-VR6[V]-IMP.2SG	салақ
салаа[N]-SG-NOM	салаа
салаа[N]-VR3[V]-IMP.2SG	салаар
салғын[N]-ADVR[ADV]	салғынын
салғын[N]-SG-NOM	салғын
салғын[N]-VR1[V]-IMP.2SG	салғынна
салда[N]-VR2[V]-IMP.2SG	салдаа
салтым[N]-SG-NOM	салтым
самовар[N]-SG-NOM	самовар
сан[N]-SG-NOM	сан
сан[N]-VR2[V]-ADJR5[A]-SG-NOM	санан
сан[N]-VR2[V]-IMP.2SG	сана
сан[N]-VR3[V]-IMP.2SG	санар
саны[PSTP]	саны
саңмай[N]-SG-NOM	саңмай
сап[N]-ADVR[ADV]	сабын
сап[N]-ATTR1[A]-SG-NOM	саптыг
сап[N]-SG-NOM	сап
сап[N]-VR2[V]-IMP.2SG	саба
саплот[N]-SG-NOM	саплот
сапӧк[N]-SG-NOM	сапӧк
сапӧк[N]-VR1[V]-IMP.2SG	сапӧкте
сар[A]-SG-NOM	сар
сарат[N]-ADVR[ADV]	сарадын
сарат[N]-ATTR1[A]-SG-NOM	сараттыг
сарат[N]-SG-NOM	сарат
сарат[N]-VR1[V]-IMP.2SG	саратта
сарбай[V]-IMP.2SG	сарбай
сарға[V]-IMP.2SG	сарға
сарға[V]-NR2[N]-SG-NOM	сарғаш
сарғай[N]-SG-NOM	сарғай
сарыг[A]-SG-NOM	сарыг
сарыг[A]-VR3[V]-IMP.2SG	сарғар
сарыг[A]-VR3[V]-NR2[N]-SG-NOM	сарғарыш
сарыг-қан[PN]-SG-NOM	сарыг-қан
сарыг-қартыға[PN]-SG-NOM	сарыг-қартыға
сарыг-қыс[PN]-SG-NOM	сарыг-қыс
сарыг-салғын[PN]-SG-NOM	сарыг-салғын
сарыг-шайбан[PN]-SG-NOM	сарыг-шайбан
сарыг-шайқыл[PN]-SG-NOM	сарыг-шайқыл
сарыг-шмелдей[PN]-SG-NOM	сарыг-шмелдей
сарын[N]-ADVR[ADV]	сарынын
сарын[N]-SG-NOM	сарын
сарын[N]-VR2[V]-ADJR2[A]-SG-NOM	сарначы
сарын[N]-VR2[V]-ADJR5[A]-SG-NOM	сарнан
сарын[N]-VR2[V]-IMP.2SG	сарна
сарын[N]-VR3[V]-ADJR5[A]-SG-NOM	сарнарын
сарын[N]-VR3[V]-IMP.2SG	сарнар
сары-челбеген[PN]-SG-NOM	сары-челбеген
сас[N]-SG-NOM	сас
сас-қара[PN]-SG-NOM	сас-қара
сат[V]-IMP.2SG	сат
сат[V]-NR12[N]-SG-NOM	сатпа
сат[V]-NR8[N]-ATTR1[A]-SG-NOM	садақтыг
сат[V]-NR8[N]-SG-NOM	садақ
сегизон[NUM]-NOM	сегизон
сегис[NUM]-NOM	сегис
сегри[V]-IMP.2SG	сегри
сегри[V]-NR6[N]-SG-NOM	сегрит
сеек[N]-SG-NOM	сеек
сеек[N]-VR1[V]-IMP.2SG	сеекте
сен[V]-IMP.2SG	сен
сенек[N]-SG-NOM	сенек
сенек[N]-VR1[V]-IMP.2SG	сенекте
серанке[N]-SG-NOM	серанке
серки[V]-IMP.2SG	серки
сес[V]-IMP.2SG	сес
сетки[V]-IMP.2SG	сетки
сетки[V]-NR6[N]-SG-NOM	сеткит
сий[V]-IMP.2SG	сий
силги[V]-ADJR5[A]-SG-NOM	силгин
силги[V]-IMP.2SG	силги
силги[V]-NR6[N]-SG-NOM	силгит
сирле[V]-IMP.2SG	сирле
сирле[V]-NR2[N]-SG-NOM	сирлеш
слеккей[N]-SG-NOM	слеккей
соған[N]-SG-NOM	соған
соған[N]-VR1[V]-IMP.2SG	соғанна
сой[V]-IMP.2SG	сой
сойға[N]-SG-NOM	сойға
сӧк[V]-IMP.2SG	сӧк
соқ[V]-IMP.2SG	соқ
сол[A]-SG-NOM	сол
сом[N]-ATTR1[A]-SG-NOM	сомныг
сом[N]-SG-NOM	сом
сом[N]-VR2[V]-IMP.2SG	сома
соо[N]-ADVR[ADV]	соон
соо[N]-SG-NOM	соо
соо[N]-VR1[V]-IMP.2SG	соола
соо[N]-VR3[V]-IMP.2SG	соор
соо[N]-VR6[V]-IMP.2SG	сооқ
соо[N]-VR8[V]-IMP.2SG	соора
сооба[ADV]	сооба
сӧӧк[N]-SG-NOM	сӧӧк
сӧӧк[N]-VR1[V]-IMP.2SG	сӧӧкте
сооқ[A]-SG-NOM	сооқ
сооқ[N]-SG-NOM	сооқ
сооқ[N]-VR2[V]-ADJR5[A]-SG-NOM	сооған
сооқ[N]-VR2[V]-IMP.2SG	сооға
соол[V]-IMP.2SG	соол
соон[N]-SG-LOC-ATTR4[A]-SG-NOM	соондағы
соон[N]-SG-NOM	соон
соон[N]-VR2[V]-IMP.2SG	соона
соон[N]-VR3[V]-IMP.2SG	соонар
соон[N]-VR7[V]-IMP.2SG	соонар
соон[N]-VR7[V]-IMP.2SG	соонғар
соонаң[ADV]	соонаң
сооп[V]-IMP.2SG	сооп
соот[V]-IMP.2SG	соот
сор[V]-IMP.2SG	сор
сорсу[V]-NR1[N]-SG-NOM	сорсуг
сорсу[V]-NR1[N]-SG-NOM	сорсуқун
сорсу[V]-NR1[N]-SG-NOM	сорсуқын
сорсу[V]-NR3[N]-SG-NOM	сорсуғу
сорсу[V]-NR3[N]-SG-NOM	сорсуғы
сорсу[V]-NR5[N]-SG-NOM	сорсуқ
сӧрте[V]-IMP.2SG	сӧрте
сӧрте[V]-NR2[N]-SG-NOM	сӧртеш
сӧрте[V]-NR6[N]-SG-NOM	сӧртет
сӧс[N]-ADVR[ADV]	сӧзин
сӧс[N]-SG-NOM	сӧс
сӧс[N]-VR1[V]-IMP.2SG	сӧсте
сра[N]-SG-NOM	сра
сра[N]-VR1[V]-IMP.2SG	срала
стене[N]-SG-NOM	стене
стол[N]-ADVR[ADV]	столын
стол[N]-SG-NOM	стол
суг[N]-ADVR[ADV]	суғын
суг[N]-SG-NOM	суг
суг[N]-VR1[V]-IMP.2SG	суғла
суг[N]-VR2[V]-IMP.2SG	суға
суғлуқ[N]-SG-NOM	суғлуқ
суғлуқ[N]-VR2[V]-IMP.2SG	суғлуға
суқ[V]-ADJR5[A]-SG-NOM	суғын
суқ[V]-IMP.2SG	суқ
суқ[V]-NR7[N]-SG-NOM	суғум
суқ[V]-NR7[N]-SG-NOM	суғым
суқса[V]-IMP.2SG	суқса
сула[N]-SG-NOM	сула
сӱме[N]-ATTR1[A]-SG-NOM	сӱмелиг
сӱме[N]-SG-NOM	сӱме
сун[V]-IMP.2SG	сун
сун[V]-NR2[N]-SG-NOM	сунуш
сун[V]-NR2[N]-SG-NOM	суныш
суна[V]-IMP.2SG	суна
сундуқ[N]-SG-NOM	сундуқ
сӱр[N]-ATTR2[A]-SG-NOM	сӱрги
сур[N]-SG-NOM	сур
сӱр[N]-SG-NOM	сӱр
сур[N]-VR2[V]-IMP.2SG	сура
сӱр[N]-VR2[V]-IMP.2SG	сӱре
сур[N]-VR3[V]-IMP.2SG	сурар
сӱр[V]-ADJR5[A]-SG-NOM	сӱрин
сӱр[V]-IMP.2SG	сӱр
сӱр[V]-NR2[N]-SG-NOM	сӱриш
сӱр[V]-NR2[N]-SG-NOM	сӱрӱш
сӱр[V]-NR3[N]-SG-NOM	сӱрги
сӱр[V]-NR3[N]-SG-NOM	сӱргӱ
сӱр[V]-NR7[N]-SG-NOM	сӱрим
сӱр[V]-NR7[N]-SG-NOM	сӱрӱм
сура[V]-IMP.2SG	сура
сура[V]-NR1[N]-SG-NOM	сураг
сура[V]-NR1[N]-SG-NOM	сурақын
сура[V]-NR2[N]-SG-NOM	сураш
сура[V]-NR6[N]-SG-NOM	сурат
сӱрт[V]-IMP.2SG	сӱрт
сус[N]-ADVR[ADV]	сузын
сус[N]-SG-NOM	сус
сус[N]-VR1[V]-ADJR5[A]-SG-NOM	сустан
сус[N]-VR1[V]-IMP.2SG	суста
сус[V]-ADJR5[A]-SG-NOM	сузын
сус[V]-IMP.2SG	сус
сӱс[V]-IMP.2SG	сӱс
сӱс[V]-NR2[N]-SG-NOM	сӱзиш
сӱс[V]-NR2[N]-SG-NOM	сӱзӱш
сӱт[N]-SG-NOM	сӱт
сӱт[N]-VR2[V]-IMP.2SG	сӱде
сыбазын[PN]-SG-NOM	сыбазын
сыбазын-оолақ[PN]-SG-NOM	сыбазын-оолақ
сыбыр[V]-IMP.2SG	сыбыр
сыбыр[V]-NR8[N]-SG-NOM	сыбырақ
сыбыра[V]-IMP.2SG	сыбыра
сыбыра[V]-NR2[N]-SG-NOM	сыбыраш
сыбыра[V]-NR5[N]-SG-NOM	сыбырақ
сывет-оолақ[PN]-SG-NOM	сывет-оолақ
сыг[V]-IMP.2SG	сыг
сыг[V]-NR2[N]-SG-NOM	сығыш
сыг[V]-NR6[N]-SG-NOM	сығыт
сығыр[V]-IMP.2SG	сығыр
сығыр[V]-NR2[N]-SG-NOM	сығырыш
сығыт-қыйғы[PN]-SG-NOM	сығыт-қыйғы
сый[N]-ADVR[ADV]	сыйын
сый[N]-SG-NOM	сый
сый[N]-VR1[V]-IMP.2SG	сыйла
сыйба[V]-IMP.2SG	сыйба
сыйба[V]-NR2[N]-SG-NOM	сыйбаш
сыйла[V]-IMP.2SG	сыйла
сыйла[V]-NR1[N]-SG-NOM	сыйлаг
сыйла[V]-NR1[N]-SG-NOM	сыйлақын
сыйла[V]-NR6[N]-SG-NOM	сыйлат
сық[V]-IMP.2SG	сық
сық[V]-NR2[N]-SG-NOM	сығыш
сық[V]-NR6[N]-SG-NOM	сығыт
сықсын[V]-IMP.2SG	сықсын
сықта[V]-IMP.2SG	сықта
сықта[V]-NR2[N]-SG-NOM	сықташ
сықта[V]-NR6[N]-SG-NOM	сықтат
сын[N]-ADVR[ADV]	сынын
сын[N]-ATTR1[A]-SG-NOM	сынныг
сын[N]-SG-NOM	сын
сын[N]-VR1[V]-IMP.2SG	сынна
сын[N]-VR2[V]-IMP.2SG	сына
сын[V]-ADJR5[A]-SG-NOM	сынын
сын[V]-IMP.2SG	сын
сын[V]-NR1[N]-SG-NOM	сынқын
сын[V]-NR1[N]-SG-NOM	сыныг
сын[V]-NR2[N]-SG-NOM	сыныш
сын[V]-NR5[N]-SG-NOM	сынық
сына[V]-IMP.2SG	сына
сынма[N]-VR2[V]-ADJR5[A]-SG-NOM	сынмаан
сынма[N]-VR2[V]-IMP.2SG	сынмаа
сыны-сайы[PN]-SG-NOM	сыны-сайы
сың[V]-IMP.2SG	сың
сыңра[N]-VR6[V]-IMP.2SG	сыңрақ
сыңра[V]-NR5[N]-SG-NOM	сыңрақ
сыр[N]-SG-NOM	сыр
сыр[N]-VR6[V]-IMP.2SG	сырық
сыраңай[ADV]	сыраңай
сырт[N]-SG-NOM	сырт
сырт[N]-SG-POSS.3SG-LOC-ATTR4[A]-SG-NOM	сыртындағы
сырық[N]-SG-NOM	сырық
сыста[V]-IMP.2SG	сыста
сыт[N]-SG-NOM	сыт
сыт[N]-VR2[V]-IMP.2SG	сыда
сыын[N]-SG-NOM	сыын
сыыт[N]-ADVR[ADV]	сыыдын
сыыт[N]-SG-NOM	сыыт
та[PART]	та
таам[N]-SG-NOM	таам
табақ[N]-ADVR[ADV]	табағын
табақ[N]-SG-NOM	табақ
табақ[N]-VR2[V]-IMP.2SG	табаға
табан[N]-SG-NOM	табан
табар[N]-SG-NOM	табар
табы[N]-SG-NOM	табы
табы[N]-VR3[V]-IMP.2SG	табыр
табы[N]-VR8[V]-IMP.2SG	табыра
табыл[V]-NR3[N]-SG-NOM	табылғы
табылға[N]-SG-NOM	табылға
табыр[N]-SG-NOM	табыр
табыр[N]-VR2[V]-IMP.2SG	табыра
табыш[N]-ADVR[ADV]	табыжын
табыш[N]-SG-NOM	табыш
таг[N]-SG-NOM	таг
таг[N]-VR2[V]-IMP.2SG	таға
тағы[PART]	тағы
тадар[N]-SG-NOM	тадар
тазыл[N]-ADVR[ADV]	тазылын
тазыл[N]-SG-NOM	тазыл
тазыл[N]-VR2[V]-ADJR5[A]-SG-NOM	тазылан
тазыл[N]-VR2[V]-IMP.2SG	тазыла
тай[V]-ADJR2[A]-SG-NOM	тайчы
тай[V]-IMP.2SG	тай
тай[V]-NR7[N]-SG-NOM	тайым
тай[V]-NR8[N]-ADVR[ADV]	тайағын
тай[V]-NR8[N]-SG-NOM	тайақ
тай[V]-NR9[N]-SG-NOM	тайл
тайақ[N]-ADVR[ADV]	тайағын
тайақ[N]-SG-NOM	тайақ
тайақ[N]-VR2[V]-ADJR5[A]-SG-NOM	тайған
тайақ[N]-VR2[V]-IMP.2SG	тайға
тайға[N]-SG-NOM	тайға
тайға[N]-VR1[V]-IMP.2SG	тайғала
тайға[N]-VR2[V]-IMP.2SG	тайғаа
тайға[N]-VR6[V]-IMP.2SG	тайғақ
тайы[N]-SG-NOM	тайы
тайыс[A]-SG-NOM	тайыс
тақ[V]-IMP.2SG	тақ
тақ[V]-NR13[N]-SG-NOM	тақчақ
тақ[V]-NR2[N]-SG-NOM	тағыш
тақ[V]-NR7[N]-SG-NOM	тағым
таққа[N]-SG-NOM	таққа
тақпай[N]-SG-NOM	тақпай
тақпы[N]-SG-NOM	тақпы
тақта[N]-SG-NOM	тақта
тақтыг[A]-SG-NOM	тақтыг
тақчақ[N]-SG-NOM	тақчақ
тал[N]-SG-NOM	тал
тал[N]-VR1[V]-IMP.2SG	талла
тал[N]-VR2[V]-IMP.2SG	тала
тал[N]-VR6[V]-IMP.2SG	талық
тал[V]-IMP.2SG	тал
тал[V]-NR12[N]-SG-NOM	талба
тал[V]-NR1[N]-SG-NOM	талқын
тал[V]-NR1[N]-SG-NOM	талыг
тал[V]-NR5[N]-SG-NOM	талық
тала[V]-IMP.2SG	тала
тала[V]-NR2[N]-SG-NOM	талаш
тала[V]-NR9[N]-SG-NOM	талал
талай[A]-SG-NOM	талай
талай[N]-SG-NOM	талай
талай[N]-VR1[V]-IMP.2SG	талайла
талаш[N]-SG-NOM	талаш
талла[V]-IMP.2SG	талла
талық[N]-SG-NOM	талық
там[N]-AG-VR1[V]-IMP.2SG	тамчыла
там[N]-AG-VR1[V]-NR2[N]-SG-NOM	тамчылаш
там[N]-SG-NOM	там
тамаш[N]-ATTR1[A]-SG-NOM	тамаштыг
тамаш[N]-SG-NOM	тамаш
тамыл[N]-SG-NOM	тамыл
тамылға[N]-SG-NOM	тамылға
тан[N]-SG-NOM	тан
тан[N]-VR1[V]-IMP.2SG	танна
тан[N]-VR2[V]-IMP.2SG	тана
тана[N]-SG-NOM	тана
тана[N]-VR1[V]-IMP.2SG	танна
тана[N]-VR6[V]-IMP.2SG	танақ
тана[V]-IMP.2SG	тана
тана[V]-NR1[N]-SG-NOM	танаг
тана[V]-NR1[N]-SG-NOM	танақын
таны[V]-IMP.2SG	таны
таны[V]-NR2[N]-SG-NOM	таныш
таң[N]-ATTR1[A]-SG-NOM	таңныг
таң[N]-SG-LOC-ATTR4[A]-SG-NOM	таңдағы
таң[N]-SG-NOM	таң
таң[N]-VR1[V]-IMP.2SG	таңна
таңзын[V]-IMP.2SG	таңзын
таңма[N]-SG-NOM	таңма
таңма[N]-VR1[V]-IMP.2SG	таңмала
тап[V]-IMP.2SG	тап
тап[V]-NR12[N]-ADVR[ADV]	таппан
тап[V]-NR2[N]-ADVR[ADV]	табыжын
тап[V]-NR2[N]-SG-NOM	табыш
тап[V]-NR8[N]-ADVR[ADV]	табағын
тап[V]-NR8[N]-SG-NOM	табақ
тар[N]-ADVR[ADV]	тарын
тар[N]-SG-NOM	тар
тар[N]-VR2[V]-IMP.2SG	тара
тара[V]-IMP.2SG	тара
тара[V]-NR2[N]-SG-NOM	тараш
тара[V]-NR5[N]-SG-NOM	тарақ
тара[V]-NR6[N]-SG-NOM	тарат
тара[V]-NR9[N]-SG-NOM	тарал
тарбақ[N]-VR2[V]-IMP.2SG	тарбаға
тарт[V]-ADJR3[A]-SG-NOM	тартқай
тарт[V]-ADJR5[A]-SG-NOM	тартын
тарт[V]-IMP.2SG	тарт
тарт[V]-NR12[N]-SG-NOM	тартпа
тарт[V]-NR2[N]-SG-NOM	тартыш
тас[A]-SG-NOM	тас
тас[N]-ADVR[ADV]	тазын
тас[N]-SG-NOM	тас
тасқыл[N]-SG-NOM	тасқыл
тасқыл[N]-VR1[V]-IMP.2SG	тасқылла
тат[N]-ADVR[ADV]	тадын
тат[N]-SG-NOM	тат
тат[N]-VR2[V]-IMP.2SG	тада
тат[N]-VR3[V]-IMP.2SG	тадар
таш[N]-ADVR[ADV]	тажын
таш[N]-ATTR2[A]-SG-NOM	ташқы
таш[N]-SG-NOM	таш
таш[N]-VR1[V]-ADJR5[A]-SG-NOM	таштан
таш[N]-VR1[V]-IMP.2SG	ташта
таш[N]-VR7[V]-IMP.2SG	ташқар
ташқын[N]-SG-NOM	ташқын
ташты[N]-SG-NOM	ташты
те[V]-IMP.2SG	те
те[V]-NR12[N]-SG-NOM	тебе
те[V]-NR1[N]-SG-NOM	тег
те[V]-NR1[N]-SG-NOM	теқин
те[V]-NR2[N]-SG-NOM	теш
те[V]-NR3[N]-ADVR[ADV]	тегин
те[V]-NR3[N]-SG-NOM	теги
те[V]-NR6[N]-SG-NOM	тет
те[V]-NR7[N]-ADVR[ADV]	темин
те[V]-NR7[N]-SG-NOM	тем
тебе[N]-SG-NOM	тебе
тебе[PSTP]	тебе
теби[N]-ADVR[ADV]	тебин
теби[N]-SG-NOM	теби
теби[N]-VR3[V]-IMP.2SG	тебир
тебир[N]-SG-NOM	тебир
тебир-алып[PN]-SG-NOM	тебир-алып
тебир-қан[PN]-SG-NOM	тебир-қан
тебир-қан-мерген[PN]-SG-NOM	тебир-қан-мерген
тебир-қартӱс[PN]-SG-NOM	тебир-қартӱс
тебир-тек[PN]-SG-NOM	тебир-тек
тебир-шойун[PN]-SG-NOM	тебир-шойун
тег[V]-IMP.2SG	тег
тегей[N]-ADVR[ADV]	тегейин
тегей[N]-ATTR1[A]-SG-NOM	тегейлиг
тегей[N]-SG-NOM	тегей
тегри[N]-ADVR[ADV]	тегрин
тегри[N]-SG-NOM	тегри
тегри-қан[PN]-SG-NOM	тегри-қан
теен[V]-IMP.2SG	теен
теен[V]-NR7[N]-SG-NOM	тееним
теер[V]-IMP.2SG	теер
тек[ADV]	тек
тек[A]-SG-NOM	тек
текпер[N]-SG-NOM	текпер
текпер[N]-VR1[V]-IMP.2SG	текперле
тем[N]-ADVR[ADV]	темин
тем[N]-SG-NOM	тем
тем[N]-VR1[V]-IMP.2SG	темне
тең[A]-SG-NOM	тең
теп[V]-ADJR5[A]-SG-NOM	тебин
теп[V]-IMP.2SG	теп
теп[V]-NR2[N]-SG-NOM	тебиш
тер[N]-ATTR2[A]-SG-NOM	терги
тер[N]-SG-NOM	тер
тер[N]-VR1[V]-IMP.2SG	терле
тер[N]-VR2[V]-IMP.2SG	тере
тербе[N]-ADVR[ADV]	тербен
тербен[N]-SG-NOM	тербен
терги[N]-SG-NOM	терги
тере[N]-SG-NOM	тере
тере[N]-VR1[V]-IMP.2SG	терле
терек[N]-SG-NOM	терек
терең[A]-SG-NOM	терең
тес[V]-ADJR5[A]-SG-NOM	тезин
тес[V]-IMP.2SG	тес
тес[V]-NR12[N]-SG-NOM	теспе
теста[N]-SG-NOM	теста
теш[N]-SG-NOM	теш
теш[N]-VR2[V]-IMP.2SG	теже
теш[V]-IMP.2SG	теш
тизе[N]-SG-NOM	тизе
тизе[N]-VR1[V]-ADJR5[A]-SG-NOM	тизелен
тизе[N]-VR1[V]-IMP.2SG	тизеле
тииң[N]-SG-NOM	тииң
тииң[N]-VR1[V]-IMP.2SG	тииңне
тииң[N]-VR2[V]-IMP.2SG	тииңе
тииң[N]-VR3[V]-IMP.2SG	тииңер
тииң[N]-VR7[V]-IMP.2SG	тииңгер
тииң[N]-VR7[V]-IMP.2SG	тииңер
тик[V]-IMP.2SG	тик
тил[N]-ADVR[ADV]	тилин
тил[N]-ATTR1[A]-SG-NOM	тиллиг
тил[N]-SG-NOM	тил
тил[N]-VR2[V]-IMP.2SG	тиле
тил[N]-VR3[V]-IMP.2SG	тилер
тиле[V]-IMP.2SG	тиле
тиле[V]-NR6[N]-SG-NOM	тилет
тиргис[V]-IMP.2SG	тиргис
тире[V]-IMP.2SG	тире
тириг[A]-SG-NOM	тириг
тирил[V]-IMP.2SG	тирил
тискин[N]-ADVR[ADV]	тискинин
тискин[N]-SG-NOM	тискин
тискин[N]-VR1[V]-IMP.2SG	тискинне
тиш[N]-SG-NOM	тиш
тиш[N]-VR1[V]-IMP.2SG	тиште
тобан[N]-SG-NOM	тобан
тӧбе[N]-VR3[V]-IMP.2SG	тӧбер
тобрақ[N]-SG-NOM	тобрақ
тог[N]-SG-NOM	тог
тог[N]-VR1[V]-ADJR5[A]-SG-NOM	тоғлан
тог[N]-VR1[V]-IMP.2SG	тоғла
тог[N]-VR2[V]-IMP.2SG	тоға
тог[N]-VR8[V]-ADJR5[A]-SG-NOM	тоғран
тог[N]-VR8[V]-IMP.2SG	тоғра
тоғалан[V]-IMP.2SG	тоғалан
тоғалан[V]-NR2[N]-SG-NOM	тоғаланыш
тоғалат[V]-IMP.2SG	тоғалат
тоғаш[N]-SG-NOM	тоғаш
тоғаш[N]-VR2[V]-IMP.2SG	тоғажа
тоғаш[N]-VR3[V]-IMP.2SG	тоғажар
тоғра[V]-ADJR5[A]-SG-NOM	тоғран
тоғра[V]-IMP.2SG	тоғра
тоғра[V]-NR7[N]-AG-VR1[V]-IMP.2SG	тоғрамчыла
тоғра[V]-NR7[N]-SG-NOM	тоғрам
тоғузон[NUM]-NOM	тоғузон
тоғус[NUM]-NOM	тоғус
тӧже[V]-ADJR5[A]-SG-NOM	тӧжен
тӧже[V]-IMP.2SG	тӧже
тӧжек[N]-SG-NOM	тӧжек
тозун[N]-SG-NOM	тозун
той[N]-ADVR[ADV]	тойын
той[N]-SG-NOM	той
той[N]-VR1[V]-IMP.2SG	тойла
тӧк[V]-IMP.2SG	тӧк
тоқ[A]-SG-NOM	тоқ
тоқ[V]-IMP.2SG	тоқ
тоқ[V]-NR11[N]-SG-NOM	тоқпақ
тоқла[V]-IMP.2SG	тоқла
тоқпақ[N]-SG-NOM	тоқпақ
тоқта[V]-IMP.2SG	тоқта
тоқта[V]-NR6[N]-SG-NOM	тоқтат
тӧл[N]-ADVR[ADV]	тӧлин
тӧл[N]-SG-LOC-ATTR4[A]-SG-NOM	тӧлдеги
тӧл[N]-SG-NOM	тӧл
тӧл[N]-VR1[V]-IMP.2SG	тӧлле
тӧл[N]-VR2[V]-IMP.2SG	тӧле
тола[V]-IMP.2SG	тола
толдыр[V]-IMP.2SG	толдыр
тӧле[V]-IMP.2SG	тӧле
толқу[V]-IMP.2SG	толқу
толуқ[N]-SG-NOM	толуқ
томазақ[N]-SG-NOM	томазақ
тон[N]-ATTR1[A]-SG-NOM	тонныг
тон[N]-SG-NOM	тон
тон[N]-VR1[V]-IMP.2SG	тонна
тон[N]-VR2[V]-ADJR5[A]-SG-NOM	тонан
тон[N]-VR2[V]-IMP.2SG	тона
тӧң[N]-SG-NOM	тӧң
тӧң[N]-VR2[V]-IMP.2SG	тӧңе
тоң[V]-IMP.2SG	тоң
тоң[V]-NR13[N]-SG-NOM	тоңчақ
тӧңеш[N]-SG-NOM	тӧңеш
тӧңеш[N]-VR1[V]-IMP.2SG	тӧңеште
тӧңзел[N]-SG-NOM	тӧңзел
тоң-кезер[PN]-SG-NOM	тоң-кезер
тоо[N]-SG-NOM	тоо
тоо[N]-VR1[V]-ADJR5[A]-SG-NOM	тоолан
тоо[N]-VR1[V]-IMP.2SG	тоола
тӧӧнче[PSTP]	тӧӧнче
тоос[N]-SG-NOM	тоос
тоос[N]-VR2[V]-IMP.2SG	тооза
тоос[V]-IMP.2SG	тоос
топақ[N]-SG-NOM	топақ
топчу[N]-ATTR1[A]-SG-NOM	топчулыг
топчу[N]-SG-NOM	топчу
топчу[N]-VR1[V]-ADJR5[A]-SG-NOM	топчулан
топчу[N]-VR1[V]-IMP.2SG	топчула
топчу[N]-VR6[V]-IMP.2SG	топчуқ
топчы[N]-SG-NOM	топчы
топчы[N]-VR1[V]-ADJR5[A]-SG-NOM	топчылан
топчы[N]-VR1[V]-IMP.2SG	топчыла
тор[N]-AG-VR6[V]-IMP.2SG	торчуқ
тор[N]-AG-VR6[V]-IMP.2SG	торчық
тор[N]-SG-NOM	тор
тӧр[N]-SG-NOM	тӧр
тор[N]-VR2[V]-IMP.2SG	тора
тӧр[N]-VR2[V]-IMP.2SG	тӧре
тӧр[N]-VR3[V]-IMP.2SG	тӧрер
тор[V]-IMP.2SG	тор
тор[V]-NR11[N]-SG-NOM	торбақ
тор[V]-NR12[N]-SG-NOM	торба
тор[V]-NR3[N]-SG-NOM	торғу
тор[V]-NR3[N]-SG-NOM	торғы
тор[V]-NR7[N]-SG-NOM	торум
тор[V]-NR7[N]-SG-NOM	торым
торбақ[N]-SG-NOM	торбақ
торбас[N]-SG-NOM	торбас
торғу[N]-SG-NOM	торғу
торғу[N]-VR6[V]-IMP.2SG	торғуқ
торғу-арыг[PN]-SG-NOM	торғу-арыг
торғу-кӧӧк[PN]-SG-NOM	торғу-кӧӧк
торғу-қан[PN]-SG-NOM	торғу-қан
тӧре[V]-IMP.2SG	тӧре
тӧре[V]-NR9[N]-SG-NOM	тӧрел
торспақ[N]-SG-NOM	торспақ
тӧрт[NUM]-NOM	тӧрт
торчуқ[N]-SG-NOM	торчуқ
торчуқ[N]-VR1[V]-IMP.2SG	торчуқта
тӧс[N]-ADVR[ADV]	тӧзин
тос[N]-SG-NOM	тос
тӧс[N]-SG-NOM	тӧс
тӧс[N]-VR1[V]-IMP.2SG	тӧсте
тос[N]-VR2[V]-IMP.2SG	тоза
тӧс[N]-VR2[V]-IMP.2SG	тӧзе
тос[V]-IMP.2SG	тос
тос[V]-NR1[N]-SG-NOM	тозуг
тос[V]-NR1[N]-SG-NOM	тозыг
тос[V]-NR1[N]-SG-NOM	тосқун
тос[V]-NR1[N]-SG-NOM	тосқын
тос[V]-NR3[N]-ADVR[ADV]	тосқун
тос[V]-NR3[N]-ADVR[ADV]	тосқын
тӧш[N]-ADVR[ADV]	тӧжин
тӧш[N]-SG-NOM	тӧш
тӧш[N]-VR1[V]-IMP.2SG	тӧште
тӧш[N]-VR2[V]-ADJR5[A]-SG-NOM	тӧжен
тӧш[N]-VR2[V]-IMP.2SG	тӧже
тубан[N]-SG-NOM	тубан
тубен[N]-SG-NOM	тубен
тӱбен[N]-SG-NOM	тӱбен
тӱбӱн[N]-SG-NOM	тӱбӱн
тӱбӱн[N]-VR2[V]-IMP.2SG	тӱбӱне
тӱген[V]-IMP.2SG	тӱген
тӱгет[V]-IMP.2SG	тӱгет
туғ[N]-SG-NOM	туғ
туғ[N]-VR1[V]-IMP.2SG	туғла
туғ[N]-VR2[V]-ADJR5[A]-SG-NOM	туған
туғ[N]-VR2[V]-IMP.2SG	туға
туғ[N]-VR3[V]-IMP.2SG	туғар
туғ[N]-VR7[V]-IMP.2SG	туғар
туғ[V]-IMP.2SG	туғ
туған[N]-SG-NOM	туған
туғла[V]-IMP.2SG	туғла
туда[N]-SG-NOM	туда
туда[N]-VR2[V]-IMP.2SG	тудаа
туда[N]-VR3[V]-IMP.2SG	тудар
тӱже[V]-IMP.2SG	тӱже
тӱже[V]-NR6[N]-SG-NOM	тӱжет
туйғақ[N]-ATTR1[A]-SG-NOM	туйғақтыг
туйғақ[N]-SG-NOM	туйғақ
тӱк[N]-ATTR1[A]-SG-NOM	тӱктиг
тӱк[N]-SG-NOM	тӱк
тӱк[N]-VR1[V]-IMP.2SG	тӱкте
тӱлгӱ[N]-SG-NOM	тӱлгӱ
тӱле[V]-IMP.2SG	тӱле
тӱн[N]-SG-NOM	тӱн
тӱн[N]-VR2[V]-IMP.2SG	тӱне
тун[V]-IMP.2SG	тун
тун[V]-NR12[N]-SG-NOM	тунма
тӱндӱк[N]-SG-NOM	тӱндӱк
туңма[N]-ATTR1[A]-SG-NOM	туңмалыг
туңма[N]-SG-NOM	туңма
туңма[N]-VR1[V]-IMP.2SG	туңмала
туңма[N]-VR6[V]-IMP.2SG	туңмақ
тӱп[N]-SG-NOM	тӱп
тӱп[N]-VR2[V]-ADJR5[A]-SG-NOM	тӱбен
тӱп[N]-VR2[V]-IMP.2SG	тӱбе
тӱплет[V]-IMP.2SG	тӱплет
тур[V]-IMP.2SG	тур
тур[V]-NR12[N]-SG-NOM	турба
тур[V]-NR1[N]-SG-NOM	турқун
тур[V]-NR1[N]-SG-NOM	турқын
тур[V]-NR1[N]-SG-NOM	туруг
тур[V]-NR1[N]-SG-NOM	турыг
тур[V]-NR2[N]-SG-NOM	туруш
тур[V]-NR2[N]-SG-NOM	турыш
тур[V]-NR5[N]-SG-NOM	туруқ
тур[V]-NR5[N]-SG-NOM	турық
тура[N]-SG-NOM	тура
тура[N]-VR2[V]-IMP.2SG	тураа
тура[N]-VR3[V]-IMP.2SG	турар
тура[N]-VR6[V]-IMP.2SG	турақ
турба[N]-SG-NOM	турба
турба[N]-VR2[V]-ADJR5[A]-SG-NOM	турбаан
турба[N]-VR2[V]-IMP.2SG	турбаа
тӱре[V]-IMP.2SG	тӱре
тӱс[A]-SG-NOM	тӱс
тӱс[A]-VR3[V]-IMP.2SG	тӱзер
тус[N]-SG-NOM	тус
тут[V]-IMP.2SG	тут
тут[V]-NR2[N]-SG-NOM	тудуш
тут[V]-NR2[N]-SG-NOM	тудыш
тутпаш[N]-SG-NOM	тутпаш
туш[N]-SG-LOC-ATTR4[A]-SG-NOM	туштағы
тӱш[N]-SG-LOC-ATTR4[A]-SG-NOM	тӱштеги
туш[N]-SG-NOM	туш
тӱш[N]-SG-NOM	тӱш
тӱш[N]-VR1[V]-ADJR5[A]-SG-NOM	тӱштен
туш[N]-VR1[V]-IMP.2SG	тушта
тӱш[N]-VR1[V]-IMP.2SG	тӱште
тӱш[N]-VR2[V]-IMP.2SG	тӱже
тӱш[N]-VR3[V]-IMP.2SG	тӱжер
тӱш[V]-IMP.2SG	тӱш
тӱш[V]-NR2[N]-SG-NOM	тӱжиш
тӱш[V]-NR2[N]-SG-NOM	тӱжӱш
тық[V]-IMP.2SG	тық
тын[N]-ADVR[ADV]	тынын
тын[N]-ATTR1[A]-SG-NOM	тынныг
тын[N]-SG-NOM	тын
тын[N]-VR1[V]-IMP.2SG	тынна
тын[N]-VR2[V]-ADJR5[A]-SG-NOM	тынан
тын[N]-VR2[V]-IMP.2SG	тына
тын[V]-ADJR5[A]-SG-NOM	тынын
тын[V]-IMP.2SG	тын
тын[V]-NR12[N]-SG-NOM	тынма
тын[V]-NR3[N]-SG-NOM	тынғы
тын[V]-NR4[N]-SG-NOM	тынғыш
тын[V]-NR7[N]-SG-NOM	тыным
тынам[N]-SG-NOM	тынам
тынам[N]-VR2[V]-IMP.2SG	тынма
тынам[N]-VR3[V]-IMP.2SG	тынмар
тыныг[N]-VR2[V]-ADJR5[A]-SG-NOM	тынған
тыныг[N]-VR2[V]-IMP.2SG	тынға
тың[ADV]1	+?
тың[ADV]	тың
тыт[N]-SG-NOM	тыт
тыт[V]-IMP.2SG	тыт
тыы[V]-ADJR5[A]-SG-NOM	тыын
тыы[V]-IMP.2SG	тыы
тыы[V]-NR6[N]-ADVR[ADV]	тыыдын
тыы[V]-NR6[N]-SG-NOM	тыыт
ӱбӱр[V]-IMP.2SG	ӱбӱр
уг[V]-IMP.2SG	уг
уг[V]-NR9[N]-SG-NOM	уғл
ӱгӱ[N]-SG-NOM	ӱгӱ
уға[N]-SG-NOM	уға
уға[N]-VR3[V]-IMP.2SG	уғар
уғжал[V]-IMP.2SG	уғжал
ӱдӱре[ADV]	ӱдӱре
ӱжеле[NUM]-NOM	ӱжеле
ӱжеле[NUM]-POSS.3SG-NOM	ӱжелези
ужу[N]-ADVR[ADV]	ужун
ужу[N]-SG-NOM	ужу
ӱжӱл[V]-IMP.2SG	ӱжӱл
ужы[N]-SG-NOM	ужы
узақ[A]-SG-NOM	узақ
узан[V]-ADJR2[A]-SG-NOM	узанчы
узан[V]-IMP.2SG	узан
узат[V]-IMP.2SG	узат
ӱзен-арыг[PN]-SG-NOM	ӱзен-арыг
узу[V]-ADJR5[A]-SG-NOM	узун
узу[V]-IMP.2SG	узу
узу[V]-NR6[N]-SG-NOM	узут
узун[A]-SG-NOM	узун
ӱзӱт[N]-SG-NOM	ӱзӱт
ӱй[N]-SG-NOM	ӱй
уй[N]-VR2[V]-IMP.2SG	уйа
ӱй[N]-VR2[V]-IMP.2SG	ӱйе
уйа[N]-ATTR1[A]-SG-NOM	уйалыг
уйа[N]-SG-NOM	уйа
уйат[N]-SG-NOM	уйат
уйат[V]-IMP.2SG	уйат
уйба[V]-IMP.2SG	уйба
уйғу[N]-SG-NOM	уйғу
уйғу[N]-VR6[V]-IMP.2SG	уйғуқ
ӱйе[N]-ATTR1[A]-SG-NOM	ӱйелиг
ӱйе[N]-SG-NOM	ӱйе
уқ[V]-ADJR3[A]-SG-NOM	уққай
уқ[V]-IMP.2SG	уқ
уқ[V]-NR12[N]-SG-NOM	уқпа
ула[V]-IMP.2SG	ула
ула[V]-NR12[N]-SG-NOM	улаба
улаба[N]-SG-NOM	улаба
ӱлге[N]-ADVR[ADV]	ӱлген
ӱлге[N]-SG-NOM	ӱлге
ӱлге[N]-VR3[V]-IMP.2SG	ӱлгер
ӱлген[PN]-SG-NOM	ӱлген
ӱлгер[A]-SG-NOM	ӱлгер
ӱлгер[N]-SG-NOM	ӱлгер
ӱлгер-мӧке[PN]-SG-NOM	ӱлгер-мӧке
улға[V]-ADJR5[A]-SG-NOM	улған
улға[V]-IMP.2SG	улға
улға[V]-NR12[N]-SG-NOM	улғаба
улға[V]-NR2[N]-SG-NOM	улғаш
улға[V]-NR6[N]-SG-NOM	улғат
улда[N]-SG-NOM	улда
ӱле[V]-IMP.2SG	ӱле
ӱле[V]-NR2[N]-SG-NOM	ӱлеш
улу[V]-IMP.2SG	улу
улу[V]-NR1[N]-ADVR[ADV]	улуғын
улу[V]-NR1[N]-ADVR[ADV]	улуқунын
улу[V]-NR1[N]-ADVR[ADV]	улуқынын
улу[V]-NR1[N]-SG-NOM	улуг
улу[V]-NR1[N]-SG-NOM	улуқун
улу[V]-NR1[N]-SG-NOM	улуқын
улу[V]-NR2[N]-SG-NOM	улуш
улу[V]-NR3[N]-ADVR[ADV]	улуғун
улу[V]-NR3[N]-ADVR[ADV]	улуғын
улу[V]-NR3[N]-SG-NOM	улуғу
улу[V]-NR3[N]-SG-NOM	улуғы
улу[V]-NR5[N]-ADVR[ADV]	улуғын
улу[V]-NR5[N]-SG-NOM	улуқ
улуг[A]-SG-NOM	улуг
улуг-қан[PN]-SG-NOM	улуг-қан
улус[N]-SG-NOM	улус
ӱлӱш[N]-SG-NOM	ӱлӱш
улыг[A]-SG-NOM	улыг
ун[N]-SG-NOM	ун
ӱн[N]-SG-NOM	ӱн
ӱн[N]-VR1[V]-IMP.2SG	ӱнне
ундут[V]-IMP.2SG	ундут
ундут[V]-NR12[N]-SG-NOM	ундутпа
ундут[V]-NR2[N]-SG-NOM	ундудуш
ундут[V]-NR2[N]-SG-NOM	ундудыш
уңна[V]-IMP.2SG	уңна
уңна[V]-NR1[N]-SG-NOM	уңнаг
уңна[V]-NR1[N]-SG-NOM	уңнақын
ӱп[N]-SG-NOM	ӱп
ӱр[ADV]	ӱр
ӱр[A]-SG-NOM	ӱр
ур[V]-IMP.2SG	ур
ур[V]-NR2[N]-SG-NOM	уруш
ур[V]-NR2[N]-SG-NOM	урыш
ӱрген[V]-IMP.2SG	ӱрген
ӱргет[V]-IMP.2SG	ӱргет
ӱргӱн[V]-IMP.2SG	ӱргӱн
ӱргӱн[V]-NR12[N]-SG-NOM	ӱргӱнме
ӱргӱн[V]-NR2[N]-SG-NOM	ӱргӱниш
ӱргӱн[V]-NR2[N]-SG-NOM	ӱргӱнӱш
ӱргӱт[V]-IMP.2SG	ӱргӱт
ӱре[V]-ADJR5[A]-SG-NOM	ӱрен
ӱре[V]-IMP.2SG	ӱре
ӱрен[N]-SG-NOM	ӱрен
ӱрӱк[N]-SG-NOM	ӱрӱк
ӱрӱк[V]-IMP.2SG	ӱрӱк
ӱрӱк[V]-NR12[N]-SG-NOM	ӱрӱкпе
урун[V]-IMP.2SG	урун
урун[V]-NR2[N]-SG-NOM	урунуш
урун[V]-NR2[N]-SG-NOM	уруныш
уруш[N]-SG-NOM	уруш
уруш[V]-IMP.2SG	уруш
ус[N]-SG-NOM	ус
ӱс[N]-SG-NOM	ӱс
ус[N]-VR1[V]-IMP.2SG	уста
ус[N]-VR2[V]-ADJR5[A]-SG-NOM	узан
ӱс[N]-VR2[V]-ADJR5[A]-SG-NOM	ӱзен
ус[N]-VR2[V]-IMP.2SG	уза
ӱс[N]-VR2[V]-IMP.2SG	ӱзе
ус[N]-VR3[V]-IMP.2SG	узар
ӱс[N]-VR7[V]-IMP.2SG	ӱскер
ӱс[V]-IMP.2SG	ӱс
ӱс[V]-NR6[N]-SG-NOM	ӱзит
ӱс[V]-NR6[N]-SG-NOM	ӱзӱт
усқан[V]-IMP.2SG	усқан
усқат[V]-IMP.2SG	усқат
усқат[V]-NR7[N]-SG-NOM	усқадым
ӱст[N]-ADVR[ADV]	ӱстин
ӱст[N]-SG-NOM	ӱст
устал[N]-SG-NOM	устал
устал[N]-VR2[V]-IMP.2SG	устала
устол[N]-SG-NOM	устол
ӱстӱ[N]-ADVR[ADV]-ATTR2[A]-SG-NOM	ӱстӱнги
ӱстӱ[N]-ADVR[ADV]	ӱстӱн
ӱстӱ[N]-SG-NOM	ӱстӱ
ӱстӱ[N]-VR1[V]-IMP.2SG	ӱстӱле
ӱстӱне[PSTP]	ӱстӱне
ӱт[N]-VR1[V]-IMP.2SG	ӱтте
ут[V]-IMP.2SG	ут
ӱчин[PSTP]	ӱчин
ӱчин-арыг[PN]-SG-NOM	ӱчин-арыг
учуқ[V]-IMP.2SG	учуқ
ӱчӱн[PSTP]	ӱчӱн
уш[N]-ATTR1[A]-SG-NOM	уштыг
уш[N]-SG-NOM	уш
ӱш[NUM]-ELA	ӱштең
ӱш[NUM]-LOC-PRED.2SG	ӱштең
ӱш[NUM]-NOM	ӱш
ӱш[NUM]-PROL	ӱшча
уш[N]-VR1[V]-IMP.2SG	ушта
уш[N]-VR2[V]-IMP.2SG	ужа
уш[N]-VR3[V]-IMP.2SG	ужар
ӱш[V]-IMP.2SG	ӱш
ӱшкӱр[V]-IMP.2SG	ӱшкӱр
ушқаш[PSTP]	ушқаш
ча[N]-ADVR[ADV]-ATTR2[A]-SG-NOM	чанғы
ча[N]-ADVR[ADV]	чан
ча[N]-ATTR1[A]-SG-NOM	чалыг
ча[N]-ATTR2[A]-SG-NOM	чағы
ча[N]-SG-NOM	ча
ча[N]-VR1[V]-ADJR5[A]-SG-NOM	чалан
ча[N]-VR1[V]-IMP.2SG	чала
ча[N]-VR2[V]-ADJR5[A]-SG-NOM	чаан
ча[N]-VR2[V]-IMP.2SG	чаа
ча[N]-VR3[V]-ADJR5[A]-SG-NOM	чарын
ча[N]-VR3[V]-IMP.2SG	чар
ча[N]-VR6[V]-ADJR5[A]-SG-NOM	чағын
ча[N]-VR6[V]-IMP.2SG	чақ
ча[N]-VR8[V]-IMP.2SG	чара
чаа[N]-SG-NOM	чаа
чаа[N]-VR1[V]-IMP.2SG	чаала
чаа[N]-VR6[V]-IMP.2SG	чаақ
чаа[V]-ADJR5[A]-SG-NOM	чаан
чаа[V]-IMP.2SG	чаа
чаа[V]-NR9[N]-SG-NOM	чаал
чаар[N]-SG-NOM	чаар
чаар[N]-VR6[V]-IMP.2SG	чаарық
чаба[N]-SG-NOM	чаба
чаба[N]-VR1[V]-IMP.2SG	чабала
чаба[N]-VR6[V]-IMP.2SG	чабақ
чабақ[N]-SG-NOM	чабақ
чабал[A]-SG-NOM	чабал
чабал[A]-VR3[V]-IMP.2SG	чабалар
чабал[A]-VR3[V]-NR12[N]-SG-NOM	чабаларба
чабал-қан-мерген[PN]-SG-NOM	чабал-қан-мерген
чабыг[N]-SG-NOM	чабыг
чабыс-чапан[PN]-SG-NOM	чабыс-чапан
чаг[N]-ADVR[ADV]	чағын
чаг[N]-SG-NOM	чаг
чаг[N]-VR2[V]-IMP.2SG	чаға
чаг[V]-ADJR5[A]-SG-NOM	чағын
чаг[V]-IMP.2SG	чаг
чаг[V]-NR12[N]-ADVR[ADV]	чағбан
чаг[V]-NR2[N]-SG-NOM	чағыш
чаға[N]-ATTR1[A]-SG-NOM	чағалыг
чаға[N]-SG-NOM	чаға
чағын[A]-SG-NOM	чағын
чағын[A]-VR3[V]-IMP.2SG	чағынар
чағыс[A]-SG-NOM	чағыс
чағыс-тайчы[PN]-SG-NOM	чағыс-тайчы
чағыс-чайан[PN]-SG-NOM	чағыс-чайан
чағыс-чайачы[PN]-SG-NOM	чағыс-чайачы
чадық[N]-SG-NOM	чадық
чадық[N]-VR1[V]-IMP.2SG	чадықта
чадық[N]-VR2[V]-ADJR5[A]-SG-NOM	чадыған
чадық[N]-VR2[V]-IMP.2SG	чадыға
чажа[V]-IMP.2SG	чажа
чажа[V]-NR6[N]-SG-NOM	чажат
чажын[N]-SG-NOM	чажын
чажыт[N]-SG-NOM	чажыт
чаза[ADV]	чаза
чаза[V]-ADJR5[A]-SG-NOM	чазан
чаза[V]-IMP.2SG	чаза
чаза[V]-NR1[N]-SG-NOM	чазаг
чаза[V]-NR1[N]-SG-NOM	чазақын
чаза[V]-NR6[N]-SG-NOM	чазат
чаза[V]-NR9[N]-SG-NOM	чазал
чазы[N]-ADVR[ADV]	чазын
чазы[N]-SG-LOC-ATTR4[A]-SG-NOM	чазыдағы
чазы[N]-SG-NOM	чазы
чазы[N]-VR6[V]-IMP.2SG	чазық
чазық[N]-VR2[V]-IMP.2SG	чазыға
чай[N]-ADVR[ADV]	чайын
чай[N]-ATTR2[A]-SG-NOM	чайғы
чай[N]-SG-NOM	чай
чай[N]-VR2[V]-ADJR2[A]-SG-NOM	чайачы
чай[N]-VR2[V]-ADJR5[A]-SG-NOM	чайан
чай[N]-VR2[V]-IMP.2SG	чайа
чай[N]-VR3[V]-IMP.2SG	чайар
чай[V]-ADJR5[A]-SG-NOM	чайын
чай[V]-IMP.2SG	чай
чай[V]-NR3[N]-SG-NOM	чайғы
чайа[V]-ADJR2[A]-SG-NOM	чайачы
чайа[V]-ADJR5[A]-SG-NOM	чайан
чайа[V]-IMP.2SG	чайа
чайа[V]-NR6[N]-SG-NOM	чайат
чайа[V]-NR9[N]-SG-NOM	чайал
чайан-арыг[PN]-SG-NOM	чайан-арыг
чайан-пурқан[PN]-SG-NOM	чайан-пурқан
чайачы[PN]-SG-NOM	чайачы
чайзаң[A]-SG-NOM	чайзаң
чайзаң[N]-SG-NOM	чайзаң
чайзаң[N]-VR1[V]-IMP.2SG	чайзаңна
чайзаң[N]-VR2[V]-IMP.2SG	чайзаңа
чайзаң-арыг[PN]-SG-NOM	чайзаң-арыг
чайқа[V]-IMP.2SG	чайқа
чайқа[V]-NR6[N]-SG-NOM	чайқат
чайқа[V]-NR9[N]-SG-NOM	чайқал
чақшы[N]-SG-NOM	чақшы
чақшы[N]-VR1[V]-IMP.2SG	чақшыла
чақшы[N]-VR6[V]-IMP.2SG	чақшық
чал[N]-ADVR[ADV]	чалын
чал[N]-ATTR1[A]-SG-NOM	чаллыг
чал[N]-SG-NOM	чал
чал[N]-VR2[V]-ADJR5[A]-SG-NOM	чалан
чал[N]-VR2[V]-IMP.2SG	чала
чала[N]-ADVR[ADV]	чалан
чала[N]-SG-NOM	чала
чала[V]-ADJR5[A]-SG-NOM	чалан
чала[V]-IMP.2SG	чала
чала[V]-NR12[N]-SG-NOM	чалаба
чала[V]-NR2[N]-SG-NOM	чалаш
чалаң[N]-SG-NOM	чалаң
чалбақ[A]-SG-NOM	чалбақ
чалға[V]-ADJR5[A]-SG-NOM	чалған
чалға[V]-IMP.2SG	чалға
чалдырық[N]-SG-NOM	чалдырық
чалтыра[V]-IMP.2SG	чалтыра
чалтыра[V]-NR2[N]-SG-NOM	чалтыраш
чалын[N]-SG-NOM	чалын
чалын[N]-VR1[V]-IMP.2SG	чалынна
чалың[N]-SG-NOM	чалың
чан[N]-ADVR[ADV]	чанын
чан[N]-ATTR2[A]-SG-NOM	чанғы
чан[N]-SG-LOC-ATTR4[A]-SG-NOM	чандағы
чан[N]-SG-NOM	чан
чан[N]-SG-POSS.3SG-LOC-ATTR4[A]-SG-NOM	чанындағы
чан[N]-VR2[V]-IMP.2SG	чана
чап[V]-IMP.2SG	чап
чап[V]-NR1[N]-SG-NOM	чабыг
чап[V]-NR1[N]-SG-NOM	чапқын
чап[V]-NR2[N]-SG-NOM	чабыш
чап[V]-NR6[N]-SG-NOM	чабыт
чап[V]-NR8[N]-SG-NOM	чабақ
чар[N]-ADVR[ADV]	чарын
чар[N]-AG-ADVR[ADV]	чарчын
чар[N]-ATTR2[A]-SG-NOM	чарғы
чар[N]-SG-NOM	чар
чар[N]-VR2[V]-IMP.2SG	чара
чар[N]-VR3[V]-IMP.2SG	чарар
чар[N]-VR6[V]-ADJR5[A]-SG-NOM	чарығын
чар[N]-VR6[V]-IMP.2SG	чарық
чар[V]-ADJR5[A]-SG-NOM	чарын
чар[V]-IMP.2SG	чар
чар[V]-NR12[N]-ADVR[ADV]	чарбан
чар[V]-NR1[N]-ADVR[ADV]	чарқынын
чар[V]-NR1[N]-ADVR[ADV]	чарығын
чар[V]-NR1[N]-SG-NOM	чарқын
чар[V]-NR1[N]-SG-NOM	чарыг
чар[V]-NR2[N]-ADVR[ADV]	чарыжын
чар[V]-NR2[N]-SG-NOM	чарыш
чар[V]-NR3[N]-SG-NOM	чарғы
чар[V]-NR5[N]-ADVR[ADV]	чарығын
чар[V]-NR5[N]-ATTR1[A]-SG-NOM	чарықтыг
чар[V]-NR5[N]-SG-GEN-ATTR2[A]-SG-NOM	+?
чар[V]-NR5[N]-SG-NOM	чарық
чар[V]-NR6[N]-SG-NOM	чарыт
чар[V]-NR7[N]-SG-NOM	чарым
чара[V]-IMP.2SG	чара
чара[V]-NR2[N]-SG-NOM	чараш
чараш[N]-SG-NOM	чараш
чараш[N]-VR6[V]-IMP.2SG	чаражық
чарба[N]-ADVR[ADV]	чарбан
чарба[N]-VR2[V]-IMP.2SG	чарбаа
чарбан[V]-IMP.2SG	чарбан
чарғанат[N]-SG-NOM	чарғанат
чарғы[N]-SG-NOM	чарғы
чарғы[N]-VR1[V]-IMP.2SG	чарғыла
чарды[N]-ATTR1[A]-SG-NOM	чардылыг
чарды[N]-ATTR2[A]-SG-NOM	чардығы
чарды[N]-SG-NOM	чарды
чарды[N]-VR1[V]-IMP.2SG	чардыла
чарды[N]-VR6[V]-ADJR5[A]-SG-NOM	чардығын
чарды[N]-VR6[V]-IMP.2SG	чардық
чардық[N]-ADVR[ADV]	чардығын
чардық[N]-SG-NOM	чардық
чардық[N]-VR1[V]-IMP.2SG	чардықта
чары[V]-ADJR5[A]-SG-NOM	чарын
чары[V]-IMP.2SG	чары
чары[V]-NR1[N]-ADVR[ADV]	чарығын
чары[V]-NR1[N]-ADVR[ADV]	чарықынын
чары[V]-NR1[N]-SG-NOM	чарыг
чары[V]-NR1[N]-SG-NOM	чарықын
чары[V]-NR2[N]-ADVR[ADV]	чарыжын
чары[V]-NR2[N]-SG-NOM	чарыш
чары[V]-NR3[N]-ADVR[ADV]	чарығын
чары[V]-NR5[N]-ADVR[ADV]	чарығын
чары[V]-NR5[N]-ATTR1[A]-SG-NOM	чарықтыг
чары[V]-NR5[N]-SG-GEN-ATTR2[A]-SG-NOM	+?
чары[V]-NR5[N]-SG-NOM	чарық
чары[V]-NR6[N]-SG-NOM	чарыт
чары[V]-NR7[N]-SG-NOM	чарым
чары[V]-NR9[N]-SG-NOM	чарыл
чарық[N]-ADVR[ADV]	чарығын
чарық[N]-ATTR1[A]-SG-NOM	чарықтыг
чарық[N]-SG-GEN-ATTR2[A]-SG-NOM	+?
чарық[N]-SG-NOM	чарық
чарық[N]-VR1[V]-IMP.2SG	чарықта
чарын[N]-ATTR1[A]-SG-NOM	чарынныг
чарын[N]-SG-NOM	чарын
чарын[N]-VR2[V]-IMP.2SG	чарна
чарын[N]-VR6[V]-IMP.2SG	чарынық
час[N]-ADVR[ADV]	чазын
час[N]-ATTR2[A]-SG-NOM	часқы
час[N]-SG-NOM	час
час[N]-VR1[V]-ADJR5[A]-SG-NOM	частан
час[N]-VR1[V]-IMP.2SG	часта
час[N]-VR2[V]-ADJR5[A]-SG-NOM	чазан
час[N]-VR2[V]-IMP.2SG	чаза
час[N]-VR3[V]-IMP.2SG	чазар
час[N]-VR6[V]-IMP.2SG	чазық
час[V]-ADJR5[A]-SG-NOM	чазын
час[V]-IMP.2SG	час
час[V]-NR1[N]-SG-NOM	чазыг
час[V]-NR1[N]-SG-NOM	часқын
час[V]-NR2[N]-SG-NOM	чазыш
час[V]-NR3[N]-SG-NOM	часқы
час[V]-NR6[N]-SG-NOM	чазыт
часқы[N]-SG-NOM	часқы
частық[N]-SG-NOM	частық
частық[N]-VR1[V]-IMP.2SG	частықта
чат[V]-ADJR3[A]-SG-NOM	чатқай
чат[V]-ADJR5[A]-SG-NOM	чадын
чат[V]-IMP.2SG	чат
чат[V]-NR1[N]-SG-NOM	чадыг
чат[V]-NR1[N]-SG-NOM	чатқын
чат[V]-NR5[N]-SG-NOM	чадық
чачақ[N]-ADVR[ADV]	чачағын
чачақ[N]-SG-NOM	чачақ
чачақ[N]-VR2[V]-IMP.2SG	чачаға
чачық[N]-VR2[V]-ADJR5[A]-SG-NOM	чачыған
чачық[N]-VR2[V]-IMP.2SG	чачыға
чаш[A]-SG-NOM	чаш
чаш[A]-VR3[V]-IMP.2SG	чажар
чаш[A]-VR3[V]-NR2[N]-SG-NOM	чажарыш
чаш[A]-VR3[V]-NR7[N]-SG-NOM	чажарым
чаш[N]-ADVR[ADV]	чажын
чаш[N]-ATTR1[A]-SG-NOM	чаштыг
чаш[N]-SG-NOM	чаш
чаш[N]-VR1[V]-IMP.2SG	чашта
чаш[N]-VR2[V]-IMP.2SG	чажа
чаш[N]-VR3[V]-IMP.2SG	чажар
чаш-кӧӧк[PN]-SG-NOM	чаш-кӧӧк
че[PART]	че
чеген[N]-SG-NOM	чеген
чегирбе[NUM]-NOM	чегирбе
чегрен[A]-SG-NOM	чегрен
чедир[V]-IMP.2SG	чедир
чеек[N]-SG-NOM	чеек
чеек-перген[PN]-SG-NOM	чеек-перген
чеени[N]-SG-NOM	чеени
чезер-мӱкӱ[PN]-SG-NOM	чезер-мӱкӱ
чек[N]-VR4[V]-IMP.2SG	чексин
чексе[V]-IMP.2SG	чексе
чел[N]-SG-NOM	чел
челбеген[PN]-SG-NOM	челбеген
челбиген[PN]-SG-NOM	челбиген
челбре[V]-IMP.2SG	челбре
челтек[N]-SG-NOM	челтек
челтек[N]-VR1[V]-IMP.2SG	челтекте
чеппе-салғын[PN]-SG-NOM	чеппе-салғын
чепсе[V]-ADJR5[A]-SG-NOM	чепсен
чепсе[V]-IMP.2SG	чепсе
чепсе[V]-NR6[N]-SG-NOM	чепсет
чер[N]-ADVR[ADV]	черин
чер[N]-ATTR1[A]-SG-NOM	черлиг
чер[N]-SG-LOC-ATTR4[A]-SG-NOM	чердеги
чер[N]-SG-NOM	чер
чер[N]-SG-POSS.3SG-LOC-ATTR4[A]-SG-NOM	чериндеги
чер[N]-VR1[V]-IMP.2SG	черле
чергем[N]-SG-NOM	чергем
чес[A]-SG-NOM	чес
чес[A]-VR3[V]-IMP.2SG	чезер
чес[N]-SG-NOM	чес
чес[N]-VR1[V]-IMP.2SG	честе
чес[N]-VR2[V]-IMP.2SG	чезе
чес[N]-VR3[V]-IMP.2SG	чезер
чес-алып[PN]-SG-NOM	чес-алып
чес-қан[PN]-SG-NOM	чес-қан
чес-оолақ[PN]-SG-NOM	чес-оолақ
чес-орғу[PN]-SG-NOM	чес-орғу
чес-ӧреккен[PN]-SG-NOM	чес-ӧреккен
чес-пилек[PN]-SG-NOM	чес-пилек
честе[N]-SG-NOM	честе
чет[N]-ADVR[ADV]	чедин
чет[N]-SG-NOM	чет
чет[N]-VR2[V]-IMP.2SG	чеде
чет[N]-VR3[V]-IMP.2SG	чедер
чет[N]-VR4[V]-IMP.2SG	четсин
чет[V]-ADJR5[A]-SG-NOM	чедин
чет[V]-IMP.2SG	чет
чет[V]-NR12[N]-SG-NOM	четпе
чет[V]-NR2[N]-SG-NOM	чедиш
чет[V]-NR3[N]-SG-NOM	четки
чет[V]-NR7[N]-SG-NOM	чедим
четти[NUM]-NOM-PRED.1PL	четтибис
четти[NUM]-NOM-PRED.2SG	четтиң
четти[NUM]-NOM-PRED.3PL	четтилер
четти[NUM]-NOM	четти
четти[NUM]-POSS.1PL-NOM	четтибис
четти[NUM]-POSS.1SG-NOM	четтим
четти[NUM]-POSS.2SG-NOM	четтиң
четтире[PSTP]	четтире
четтон[NUM]-NOM	четтон
чи[V]-IMP.2SG	чи
чи[V]-NR12[N]-SG-NOM	чибе
чи[V]-NR2[N]-ADVR[ADV]	чижин
чи[V]-NR2[N]-SG-NOM	чиш
чи[V]-NR6[N]-SG-NOM	чит
чибек[N]-SG-NOM	чибек
чии[V]-IMP.2SG	чии
чии[V]-NR2[N]-SG-NOM	чииш
чилеп[PSTP]	чилеп
чип[N]-SG-NOM	чип
чип[N]-VR2[V]-IMP.2SG	чибе
чип[N]-VR3[V]-IMP.2SG	чибер
чит[V]-IMP.2SG	чит
читке[N]-ADVR[ADV]	читкен
читке[N]-SG-NOM	читке
чоғул[VNEG]-3PL	чоғуллар
чоғул[VNEG]-3SG=EMP1	чоғулоқ
чоғул[VNEG]-3SG=EMP2	чоғул-но
чоғул[VNEG]-3SG	чоғул
чоғул[VNEG]=EMP1-3SG	чоғулоқ
чода[N]-ATTR1[A]-SG-NOM	чодалыг
чода[N]-SG-NOM	чода
чозақ[N]-ADVR[ADV]	чозағын
чозақ[N]-SG-NOM	чозақ
чой[N]-SG-NOM	чой
чой[N]-VR1[V]-IMP.2SG	чойла
чоқ[A]-SG-NOM	чоқ
чол[N]-ADVR[ADV]	чолын
чол[N]-SG-NOM	чол
чол[N]-VR1[V]-IMP.2SG	чолла
чӧл[N]-VR2[V]-ADJR5[A]-SG-NOM	чӧлен
чол[N]-VR2[V]-IMP.2SG	чола
чӧл[N]-VR2[V]-IMP.2SG	чӧле
чол[N]-VR3[V]-IMP.2SG	чолар
чол-қара[PN]-SG-NOM	чол-қара
чон[N]-ADVR[ADV]	чонын
чон[N]-SG-NOM	чон
чон[N]-VR1[V]-IMP.2SG	чонна
чооқ[N]-SG-NOM	чооқ
чооқ[N]-VR1[V]-ADJR5[A]-SG-NOM	чооқтан
чооқ[N]-VR1[V]-IMP.2SG	чооқта
чоон[A]-SG-NOM	чоон
чоор[V]-IMP.2SG	чоор
чӧп[N]-SG-NOM	чӧп
чӧп[N]-VR1[V]-IMP.2SG	чӧпте
чӧр[V]-IMP.2SG	чӧр
чӧр[V]-NR12[N]-SG-NOM	чӧрбе
чӧр[V]-NR3[N]-SG-NOM	чӧрги
чӧр[V]-NR3[N]-SG-NOM	чӧргӱ
чоруқ[N]-SG-NOM	чоруқ
чоруқ[N]-VR1[V]-IMP.2SG	чоруқта
чорық[N]-SG-NOM	чорық
чос[N]-SG-NOM	чос
чос[V]-IMP.2SG	чос
чос[V]-NR8[N]-ADVR[ADV]	чозағын
чос[V]-NR8[N]-SG-NOM	чозақ
чӱген[N]-ADVR[ADV]	чӱгенин
чӱген[N]-ATTR1[A]-SG-NOM	чӱгенниг
чӱген[N]-SG-NOM	чӱген
чӱген[N]-VR1[V]-IMP.2SG	чӱгенне
чӱгӱр[V]-IMP.2SG	чӱгӱр
чӱгӱр[V]-NR2[N]-SG-NOM	чӱгӱриш
чӱгӱр[V]-NR2[N]-SG-NOM	чӱгӱрӱш
чӱк[N]-SG-NOM	чӱк
чӱк[N]-VR1[V]-ADJR5[A]-SG-NOM	чӱктен
чӱк[N]-VR1[V]-IMP.2SG	чӱкте
чуқ[N]-SG-NOM	чуқ
чуққа[ADV]	чуққа
чул[V]-IMP.2SG	чул
чул[V]-NR4[N]-SG-NOM	чулғуш
чул[V]-NR4[N]-SG-NOM	чулғыш
чулат[N]-SG-NOM	чулат
чулат[N]-VR1[V]-IMP.2SG	чулатта
чун[V]-IMP.2SG	чун
чӱрек[N]-ATTR1[A]-SG-NOM	чӱректиг
чӱрек[N]-SG-NOM	чӱрек
чурт[N]-ADVR[ADV]	чуртын
чурт[N]-SG-NOM	чурт
чурт[N]-VR1[V]-IMP.2SG	чуртта
чурт[N]-VR2[V]-IMP.2SG	чурта
чурчу[N]-SG-NOM	чурчу
чӱс[N]-SG-NOM	чӱс
чӱс[NUM]-DAT	чӱске
чӱс[NUM]-NOM	чӱс
чӱс[NUM]-POSS.2PL-ACC	чӱстериңни
чӱс[NUM]-POSS.3SG-NOM	чӱзи
чӱс[N]-VR1[V]-IMP.2SG	чӱсте
чӱс[V]-IMP.2SG	чӱс
чӱс[V]-NR7[N]-SG-NOM	чӱзим
чӱс[V]-NR7[N]-SG-NOM	чӱзӱм
чӱстӱк[N]-SG-NOM	чӱстӱк
чӱтче[ADV]	чӱтче
чӱче[ADV]	чӱче
чыг[V]-IMP.2SG	чыг
чығыл[V]-IMP.2SG	чығыл
чығыл[V]-NR2[N]-SG-NOM	чығылыш
чыда[N]-SG-NOM	чыда
чыл[N]-ADVR[ADV]	чылын
чыл[N]-SG-NOM	чыл
чыл[N]-VR1[V]-IMP.2SG	чылла
чыл[N]-VR2[V]-ADJR5[A]-SG-NOM	чылан
чыл[N]-VR2[V]-IMP.2SG	чыла
чыл[V]-ADJR5[A]-SG-NOM	чылын
чыл[V]-IMP.2SG	чыл
чыл[V]-NR1[N]-SG-NOM	чылқын
чыл[V]-NR1[N]-SG-NOM	чылыг
чыл[V]-NR2[N]-SG-NOM	чылыш
чыл[V]-NR3[N]-SG-NOM	чылғы
чылан[N]-SG-NOM	чылан
чылан-қан[PN]-SG-NOM	чылан-қан
чылан-қаны[PN]-SG-NOM	чылан-қаны
чылан-моңус[PN]-SG-NOM	чылан-моңус
чылан-моос[PN]-SG-NOM	чылан-моос
чылаш[A]-SG-NOM	чылаш
чылтыс[N]-SG-NOM	чылтыс
чылы[V]-ADJR5[A]-SG-NOM	чылын
чылы[V]-IMP.2SG	чылы
чылы[V]-NR1[N]-SG-NOM	чылыг
чылы[V]-NR1[N]-SG-NOM	чылықын
чылы[V]-NR2[N]-SG-NOM	чылыш
чымчақ[A]-SG-NOM	чымчақ
чырғал[N]-SG-NOM	чырғал
чыс[N]-ATTR1[A]-SG-NOM	чыстыг
чыс[N]-SG-NOM	чыс
чыс[N]-VR1[V]-IMP.2SG	чыста
чыш[N]-ADVR[ADV]	чыжын
чыш[N]-SG-NOM	чыш
чыы[V]-ADJR5[A]-SG-NOM	чыын
чыы[V]-IMP.2SG	чыы
чыы[V]-NR9[N]-SG-NOM	чыыл
шаай[N]-SG-NOM	шаай
шабал[N]-SG-NOM	шабал
шабал[N]-VR1[V]-IMP.2SG	шабалла
шабыр[N]-ADVR[ADV]	шабырын
шабыр[N]-SG-NOM	шабыр
шаг[N]-ADVR[ADV]	шағын
шаг[N]-SG-NOM	шаг
шаг[N]-VR1[V]-IMP.2SG	шағла
шаг[N]-VR2[V]-IMP.2SG	шаға
шаг[N]-VR3[V]-IMP.2SG	шағар
шаг[N]-VR7[V]-IMP.2SG	шағар
шағын[N]-SG-NOM	шағын
шағын[N]-VR1[V]-IMP.2SG	шағынна
шай[N]-SG-NOM	шай
шақ[N]-ADVR[ADV]	шағын
шақ[N]-SG-NOM	шақ
шақ[N]-VR1[V]-IMP.2SG	шақта
шақ[N]-VR2[V]-IMP.2SG	шаға
шақ[N]-VR3[V]-IMP.2SG	шағар
шақпын[N]-SG-NOM	шақпын
шал[V]-IMP.2SG	шал
шал[V]-NR14[N]-SG-NOM	шалчық
шала[ADV]	шала
шалғын[N]-SG-NOM	шалғын
шалчық[N]-SG-NOM	шалчық
шамдар[A]-SG-NOM	шамдар
шан[N]-SG-NOM	шан
шан[N]-VR2[V]-IMP.2SG	шана
шана[N]-SG-NOM	шана
шана[N]-VR6[V]-IMP.2SG	шанақ
шанақ[N]-SG-NOM	шанақ
шаң[N]-SG-NOM	шаң
шап[N]-ADVR[ADV]	шабын
шап[N]-ATTR1[A]-SG-NOM	шаптыг
шап[N]-SG-NOM	шап
шап[N]-VR1[V]-IMP.2SG	шапта
шап[N]-VR2[V]-IMP.2SG	шаба
шап[N]-VR3[V]-ADJR5[A]-SG-NOM	шабарын
шап[N]-VR3[V]-IMP.2SG	шабар
шап[N]-VR6[V]-IMP.2SG	шабық
шап[V]-ADJR3[A]-SG-NOM	шапқай
шап[V]-ADJR5[A]-SG-NOM	шабын
шап[V]-IMP.2SG	шап
шап[V]-NR12[N]-SG-NOM	шаппа
шап[V]-NR2[N]-ADVR[ADV]	шабыжын
шап[V]-NR2[N]-SG-NOM	шабыш
шап[V]-NR5[N]-SG-NOM	шабық
шапа[N]-SG-NOM	шапа
шапқы[N]-VR1[V]-IMP.2SG	шапқыла
шаппа[N]-SG-NOM	шаппа
шаппа[N]-VR2[V]-ADJR5[A]-SG-NOM	шаппаан
шаппа[N]-VR2[V]-IMP.2SG	шаппаа
шаппа[N]-VR6[V]-IMP.2SG	шаппақ
шар[N]-AG-ADVR[ADV]	шарчын
шар[N]-SG-NOM	шар
шар[N]-VR2[V]-IMP.2SG	шара
шара[N]-SG-NOM	шара
шара[N]-VR6[V]-IMP.2SG	шарақ
шарчын[N]-SG-NOM	шарчын
шарчын[N]-VR2[V]-IMP.2SG	шарчына
шары[V]-IMP.2SG	шары
шары[V]-NR5[N]-ATTR1[A]-SG-NOM	шарықтыг
шары[V]-NR5[N]-SG-NOM	шарық
шары[V]-NR9[N]-SG-NOM	шарыл
шарық[N]-ATTR1[A]-SG-NOM	шарықтыг
шарық[N]-SG-NOM	шарық
шачақ[N]-SG-NOM	шачақ
шачыл[V]-IMP.2SG	шачыл
шаш[N]-ADVR[ADV]	шажын
шаш[N]-ATTR1[A]-SG-NOM	шаштыг
шаш[N]-SG-NOM	шаш
шаш[N]-VR1[V]-IMP.2SG	шашта
шаш[N]-VR2[V]-IMP.2SG	шажа
шаш[V]-ADJR5[A]-SG-NOM	шажын
шаш[V]-IMP.2SG	шаш
шеден[N]-SG-NOM	шеден
шеден[N]-VR1[V]-IMP.2SG	шеденне
шеден[V]-IMP.2SG	шеден
шедик[ADV]	шедик
шел[V]-IMP.2SG	шел
шен[N]-SG-NOM	шен
шен[N]-VR2[V]-IMP.2SG	шене
шени[PSTP]	шени
шериг[N]-SG-NOM	шериг
шерке[N]-SG-NOM	шерке
шерт[V]-IMP.2SG	шерт
шеч[V]-ADJR5[A]-SG-NOM	шечин
шеч[V]-IMP.2SG	шеч
шеш[V]-IMP.2SG	шеш
ший[V]-IMP.2SG	ший
шире[N]-ADVR[ADV]	ширен
шире[N]-VR2[V]-IMP.2SG	ширее
ширен[V]-IMP.2SG	ширен
ширке[N]-SG-NOM	ширке
шиш[N]-SG-NOM	шиш
шиш[N]-VR1[V]-IMP.2SG	шиште
шиш[V]-IMP.2SG	шиш
шмелдей[PN]-SG-NOM	шмелдей
шог[N]-SG-NOM	шог
шог[N]-VR1[V]-IMP.2SG	шоғла
шоду[N]-SG-NOM	шоду
шӧй[V]-IMP.2SG	шӧй
шойун[N]-SG-NOM	шойун
шойун[N]-VR1[V]-IMP.2SG	шойунна
шойын[N]-SG-NOM	шойын
шӧк[V]-IMP.2SG	шӧк
шӧк[V]-NR12[N]-SG-NOM	шӧкпе
шӧкпе[N]-SG-NOM	шӧкпе
шӧл[N]-SG-NOM	шӧл
шола[N]-ATTR1[A]-SG-NOM	шолалыг
шола[N]-SG-NOM	шола
шола[V]-IMP.2SG	шола
шола[V]-NR7[N]-SG-NOM	шолам
шолбан[N]-SG-NOM	шолбан
шӧп[N]-SG-NOM	шӧп
шор[N]-ATTR1[A]-SG-NOM	шорлыг
шор[N]-SG-NOM	шор
шор[N]-VR1[V]-IMP.2SG	шорла
шортан[N]-SG-NOM	шортан
шот[N]-ADVR[ADV]	шодын
шот[N]-SG-NOM	шот
шочу[V]-NR1[N]-SG-NOM	шочуг
шочу[V]-NR1[N]-SG-NOM	шочуқун
шочу[V]-NR1[N]-SG-NOM	шочуқын
шубал[N]-SG-NOM	шубал
шӱбе[N]-SG-NOM	шӱбе
шӱбе[N]-VR1[V]-IMP.2SG	шӱбеле
шулан[N]-SG-NOM	шулан
шӱле[V]-IMP.2SG	шӱле
шур[V]-IMP.2SG	шур
шурла[V]-IMP.2SG	шурла
шурла[V]-NR6[N]-SG-NOM	шурлат
шығанақ[N]-VR1[V]-IMP.2SG	шығанақта
шығара[PSTP]	шығара
шыда[V]-IMP.2SG	шыда
шыда[V]-NR2[N]-SG-NOM	шыдаш
шық[V]-ADJR3[A]-SG-NOM	шыққай
шық[V]-IMP.2SG	шық
шық[V]-NR12[N]-ADVR[ADV]	шықпан
шық[V]-NR12[N]-SG-NOM	шықпа
шық[V]-NR2[N]-SG-NOM	шығыш
шыла[V]-IMP.2SG	шыла
шыла[V]-NR1[N]-SG-NOM	шылаг
шыла[V]-NR1[N]-SG-NOM	шылақын
шыла[V]-NR3[N]-SG-NOM	шылағы
шыла[V]-NR5[N]-SG-NOM	шылақ
шыла[V]-NR8[N]-SG-NOM	шылаақ
шым[ADV]	шым
шым[A]-SG-NOM	шым
шым[N]-SG-NOM	шым
шым[N]-VR6[V]-IMP.2SG	шымық
шын[N]-ADVR[ADV]	шынын
шын[N]-SG-NOM	шын
шын[N]-VR2[V]-IMP.2SG	шына
шын[N]-VR6[V]-IMP.2SG	шынық
шынық[N]-SG-NOM	шынық
шынық[N]-VR1[V]-IMP.2SG	шынықта
шыңыр[V]-IMP.2SG	шыңыр
шырай[N]-ATTR1[A]-SG-NOM	шырайлыг
шырай[N]-SG-NOM	шырай
шырақ[N]-SG-NOM	шырақ
шыыла[V]-IMP.2SG	шыыла
шыыла[V]-NR1[N]-SG-NOM	шыылаг
шыыла[V]-NR1[N]-SG-NOM	шыылақын
шыыла[V]-NR3[N]-SG-NOM	шыылағы
шыыла[V]-NR5[N]-SG-NOM	шыылақ
ығыл[V]-IMP.2SG	ығыл
ығыл[V]-NR2[N]-SG-NOM	ығылыш
ығыра[V]-IMP.2SG	ығыра
ығыра[V]-NR1[N]-SG-NOM	ығыраг
ығыра[V]-NR1[N]-SG-NOM	ығырақын
ығыра[V]-NR2[N]-SG-NOM	ығыраш
ығыра[V]-NR3[N]-SG-NOM	ығырағы
ығыра[V]-NR5[N]-SG-NOM	ығырақ
ызай[V]-IMP.2SG	ызай
ызы[N]-VR3[V]-IMP.2SG	ызыр
ызы[N]-VR6[V]-IMP.2SG	ызық
ызық[A]-SG-NOM	ызық
ызыр[V]-IMP.2SG	ызыр
ызыр[V]-NR8[N]-SG-NOM	ызырақ
ық[V]-IMP.2SG	ық
ылға[V]-IMP.2SG	ылға
ылға[V]-NR2[N]-SG-NOM	ылғаш
ылға[V]-NR6[N]-SG-NOM	ылғат
ына[V]-IMP.2SG	ына
ыпта[ADV]	ыпта
ыр[N]-SG-NOM	ыр
ыр[N]-VR2[V]-IMP.2SG	ыра
ыр[V]-IMP.2SG	ыр
ыр[V]-NR8[N]-SG-NOM	ырақ
ыра[V]-IMP.2SG	ыра
ыра[V]-NR1[N]-SG-NOM	ыраг
ыра[V]-NR1[N]-SG-NOM	ырақын
ыра[V]-NR3[N]-SG-NOM	ырағы
ыра[V]-NR5[N]-SG-NOM	ырақ
ырыс[N]-SG-NOM	ырыс
ыс[V]-IMP.2SG	ыс
ыс[V]-NR5[N]-SG-NOM	ызық
ыш[N]-SG-NOM	ыш
ышқын[V]-IMP.2SG	ышқын
ыы[N]-SG-NOM	ыы
э[V]-ADJR5[A]-SG-NOM	эн
э[V]-IMP.2SG	э
э[V]-NR12[N]-SG-NOM	эбе
э[V]-NR2[N]-ATTR1[A]-SG-NOM	эштиг
э[V]-NR2[N]-SG-NOM	эш
э[V]-NR5[N]-SG-NOM	эқ
э[V]-NR6[N]-ADVR[ADV]	эдин
э[V]-NR6[N]-ATTR1[A]-SG-NOM	эттиг
э[V]-NR6[N]-SG-NOM	эт
э[V]-NR7[N]-SG-LOC-ATTR4[A]-SG-NOM	эмдеги
э[V]-NR7[N]-SG-NOM	эм
э[V]-NR9[N]-SG-NOM	эл
эбес[VNEG]-2PL	эбессаар
эбес[VNEG]-2PL	эбессар
эбес[VNEG]-2SG	эбессиң
эбес[VNEG]-3PL	эбестер
эбес[VNEG]-3SG=EMP1	эбезоқ
эбес[VNEG]-3SG	эбес
эбес[VNEG]=EMP1-3SG	эбезоқ
эби[N]-VR3[V]-IMP.2SG	эбир
эбир[V]-IMP.2SG	эбир
эг[V]-IMP.2SG	эг
эгбен[N]-SG-NOM	эгбен
эге[V]-ADJR5[A]-SG-NOM	эген
эге[V]-IMP.2SG	эге
эген[V]-IMP.2SG	эген
эген[V]-NR12[N]-SG-NOM	эгенме
эген[V]-NR2[N]-ATTR1[A]-SG-NOM	эгеништиг
эген[V]-NR2[N]-SG-NOM	эгениш
эде[ADV]-ATTR2[A]-SG-NOM	эдеги
эде[ADV]	эде
эдек[N]-SG-NOM	эдек
эжик[N]-ATTR1[A]-SG-NOM	эжиктиг
эжик[N]-SG-NOM	эжик
эжик[N]-VR1[V]-IMP.2SG	эжикте
эзе[INTJ]	эзе
эзе[V]-ADJR5[A]-SG-NOM	эзен
эзе[V]-IMP.2SG	эзе
эзен[N]-ADVR[ADV]	эзенин
эзен[N]-SG-NOM	эзен
эзен[N]-VR1[V]-IMP.2SG	эзенне
эзен[N]-VR2[V]-IMP.2SG	эзене
эзер[N]-ADVR[ADV]	эзерин
эзер[N]-ATTR1[A]-SG-NOM	эзерлиг
эзер[N]-SG-NOM	эзер
эзер[N]-VR1[V]-ADJR5[A]-SG-NOM	эзерлен
эзер[N]-VR1[V]-IMP.2SG	эзерле
эк[V]-IMP.2SG	эк
эккей[INTJ]	эккей
экси[N]-SG-NOM	экси
экси[N]-VR1[V]-IMP.2SG	эксиле
эл[N]-SG-NOM	эл
элбек[A]-SG-NOM	элбек
элек[N]-SG-NOM	элек
элиг[NUM]-NOM	элиг
эм[N]-SG-LOC-ATTR4[A]-SG-NOM	эмдеги
эм[N]-SG-NOM	эм
эм[N]-VR2[V]-IMP.2SG	эме
эм[V]-ADJR5[A]-SG-NOM	эмин
эм[V]-IMP.2SG	эм
эмчек[N]-ATTR1[A]-SG-NOM	эмчектиг
эмчек[N]-SG-NOM	эмчек
эмчек[N]-VR1[V]-IMP.2SG	эмчекте
эн[N]-ATTR1[A]-SG-NOM	энниг
эн[N]-SG-NOM	эн
эн[N]-VR2[V]-IMP.2SG	эне
эн[N]-VR3[V]-IMP.2SG	энер
эн[V]-IMP.2SG	эн
эн[V]-NR2[N]-SG-NOM	эниш
эне[N]-ATTR1[A]-SG-NOM	энелиг
эне[N]-SG-NOM	эне
эне[N]-VR2[V]-IMP.2SG	энее
эне[N]-VR3[V]-IMP.2SG	энер
эңдер[V]-IMP.2SG	эңдер
эңчей[V]-IMP.2SG	эңчей
эп[N]-AG-VR1[V]-IMP.2SG	эпчиле
эп[N]-ATTR1[A]-SG-NOM	эптиг
эп[N]-SG-NOM	эп
эп[N]-VR1[V]-IMP.2SG	эпте
эп[N]-VR2[V]-IMP.2SG	эбе
эпчи[N]-SG-NOM	эпчи
эпчи[N]-VR1[V]-IMP.2SG	эпчиле
эр[N]-ADVR[ADV]	эрин
эр[N]-ATTR1[A]-SG-NOM	эрлиг
эр[N]-ATTR2[A]-SG-NOM	эрги
эр[N]-SG-NOM	эр
эр[N]-VR2[V]-ADJR5[A]-SG-NOM	эрен
эр[N]-VR2[V]-IMP.2SG	эре
эрбек[N]-ATTR1[A]-SG-NOM	эрбектиг
эрбек[N]-SG-NOM	эрбек
эрбек[N]-VR1[V]-ADJR5[A]-SG-NOM	эрбектен
эрбек[N]-VR1[V]-IMP.2SG	эрбекте
эргек[N]-SG-NOM	эргек
эргек[N]-VR1[V]-IMP.2SG	эргекте
эреле[V]-IMP.2SG	эреле
эри[N]-ADVR[ADV]	эрин
эри[N]-SG-NOM	эри
эрим[N]-SG-NOM	эрим
эрке[N]-ADVR[ADV]	эркен
эрке[N]-SG-NOM	эрке
эрке[N]-VR1[V]-IMP.2SG	эркеле
эрке-қан[PN]-SG-NOM	эрке-қан
эркен[N]-SG-NOM	эркен
эр-қулатай[PN]-SG-NOM	эр-қулатай
эрлик[PN]-SG-NOM	эрлик
эрлик-қан[PN]-SG-NOM	эрлик-қан
эрни[N]-SG-NOM	эрни
эрт[V]-IMP.2SG	эрт
эрт[V]-NR2[N]-SG-NOM	эртиш
эрте[A]-SG-NOM	эрте
эртен[N]-ATTR2[A]-SG-NOM	эртенги
эртен[N]-SG-LOC-ATTR4[A]-SG-NOM	эртендеги
эртен[N]-SG-NOM	эртен
эс[N]-ATTR2[A]-SG-NOM	эски
эс[N]-SG-NOM	эс
эс[N]-VR1[V]-IMP.2SG	эсте
эс[N]-VR2[V]-ADJR5[A]-SG-NOM	эзен
эс[N]-VR2[V]-IMP.2SG	эзе
эс[N]-VR3[V]-ADJR5[A]-SG-NOM	эзерин
эс[N]-VR3[V]-IMP.2SG	эзер
эс[V]-IMP.2SG	эс
эс[V]-NR3[N]-SG-NOM	эски
эски[A]-SG-NOM	эски
эсте[V]-IMP.2SG	эсте
эсте[V]-NR6[N]-SG-NOM	эстет
эсте[V]-NR7[N]-SG-NOM	эстем
эсте[V]-NR9[N]-SG-NOM	эстел
эт[N]-ADVR[ADV]	эдин
эт[N]-ATTR1[A]-SG-NOM	эттиг
эт[N]-SG-NOM	эт
эт[N]-VR1[V]-IMP.2SG	этте
эт[N]-VR2[V]-IMP.2SG	эде
эт[V]-ADJR5[A]-SG-NOM	эдин
эт[V]-IMP.2SG	эт
эт[V]-NR7[N]-SG-NOM	эдим
эш[N]-ATTR1[A]-SG-NOM	эштиг
эш[N]-SG-NOM	эш
эш[N]-VR1[V]-ADJR5[A]-SG-NOM	эштен
эш[N]-VR1[V]-IMP.2SG	эште
эш[V]-IMP.2SG	эш
ээ[N]-ADVR[ADV]	ээн
ээ[N]-ATTR2[A]-SG-NOM	ээги
ээ[N]-SG-NOM	ээ
ээ[N]-VR6[V]-IMP.2SG	ээқ
ээзи[N]-SG-NOM	ээзи
ээл[V]-IMP.2SG	ээл
ээн[A]-SG-NOM	ээн
ээш[A]-SG-NOM	ээш
