аа	мест.	
аара-пеере	нареч.	
абыртқа	сущ.	
адаңмада	прил.	
адат	глаг.	
адыжаға	глаг.	
адын	сущ.	
адына	сущ.	
адының	сущ.	
ажа	дееприч.	
ажылбас	прич.	
ажып	дееприч.	
азағын	сущ.	
азақтат	глаг.	
айға-кӱнге	сущ.	
айдаға	глаг.	
айландыр	глаг.	
айландыра	дееприч.	
айтчар	глаг.	
акирди	глаг.	
акӧке	имя собств.	
акӧке-ачам	имя собств. (мой ст. брат (дядя) Акоке)	
ақ-сарат	масть коня, прил.	
аларынға	мест.	
албазам	глаг.	
алдына	нареч.	
алдынаң	нареч.	
алларынаң	мест.	
алтын-мӧкӧ	имя собств.	
алтын-торғуну	имя собств.	
алтынаң	нареч.	
алтынғызы	прил.	
алыжып	дееприч.	
алына	дееприч. Или предлог	
алынаң	нареч.	
алынға	мест.	
алында	предл. Или нареч.	
алындағы	прил.	
алышпас	прич.	
ам	нареч.	
амды	нареч.	
амдығы	прил.	
амоқ	нареч.	
андиг	мест. М.б.местоим.прилагатательное?	
андыг	то же самое	
ара-чара	нареч.	
аразынаң	нареч.	
аран	кусок собств.имени богатыря	
аран-тайчы	имя собств	
аранчула	имя собств	
арған	прил.	
арғулус	сущ.	
арий	нареч.	
арта-перте	нареч.	
артығы	прил.	
артық	прил.	
ары	надо смотреть контекст: м.б. и сущ., м.б. и нареч., м.б.послелог	
аттарынаң	сущ.	
ашық	дееприч. Сокращ.форма	
ба	вопросит.частица	
бе	то же самое	
да	частица	
де	частица	
ижип	дееприч.	
изебинге	сущ.	
изебинең	сущ.	
ийгеле	числит.	
ийгинчи	числит.	
испишкеге	сущ.	
ича	сущ.	
иштинге	нареч.	
иштинде	нареч.	
иштине	нареч.	
иштинең	нареч.	
кебин	сущ.	
кедере	нареч.	
кезе	дееприч.	
кезип	дееприч.	
кексинге	нареч. Послелог	
кексинде	то же самое	
кексине	то же самое	
кексинең	то же самое	
келгенин	отглаг.сущ.?	
келзе	глаг.	
келижер	дееприч.	
келчер	глаг.	
кенчи	прил.	
кер	масть коня, прил.	
керил	дееприч.	
кес	глаг.	
кескен	прич.	
кести	глаг.	
кестик	сущ.	
кесчең	прич.	
кибирен	???	
кижен	сущ.	
киреең	глаг. Императив	
кирибисти	глаг.	
кирибистилер	глаг.	
кирлес	сущ.	
кирлеске	сущ.	
кирлестең	сущ.	
кичей	часть имени собств.	
киштепча	глаг.	
кӧгей	часть имени собств.	
кӧже	сущ.	
кӧзе-қара	нареч.	
кӧзӱнектең	сущ.	
кӧзӱнекти	сущ.	
кӧп	прил.	
кӧреең	глаг., императив	
кӧрееңнер	то же самое	
кӧрзе	глаг.	
кӧрӧйин	глаг.	
кӧрӱнди	глаг.	
кӧрӱндӱ	глаг.	
кӧрӱштӱрча	глаг.	
кӱжи	сущ.	
кӱжим	сущ.	
кӱжӱ	сущ.	
кӱжӱм	сущ.	
кӱжӱң	сущ.	
кӱзеңе	сущ.	
кӱзетчи	сущ.	
кӱннӱң	сущ.	
кӱнӱ	м.б. описка, в любом случае это сущ.	
кӱңни	сущ.	
кӱрежеге	супин	
кӱчин	сущ.	
кӱштӱг	прил.	
қабағында	сущ.	
қабыжа	дееприч.	
қабыжа-қабыжа	дееприч.	
қабыжаға	глаг. (супин)	
қабыжарда	глаг. 	
қабыжыбыза	дееприч.	
қағыжып	дееприч.	
қадыг	прил.	
қажы	мест. Или сущ.	
қажына	нареч., послелог	
қажынға	нареч., послелог	
қажында	нареч., послелог	
қазын	сущ.	
қазыр	прил.	
қайде	мест.	
қайдиг	прил.	
қайдығ	прил.	
қайран	прил.	
қақсалыш	дееприч. (сокращ.)	
қалтар	масть коня, прил.	
қаморта	нареч.	
қан-алып	имя собств.	
қан-перген	имя собств.	
қаны-пийи	сущ.	
қанық	дееприч. (сокращ.)	
қапчығай	нареч.	
қара-моңустың	имя собств.	
қарағызын	сущ.	
қарағынаң	сущ.	
қарат	мать коня вместе со словом конь	
қаратқа	то же самое	
қаратты	то же самое, но м.б. и часть имени собственного	
қаратты-перген	имя собств.	
қараттың	то же самое	
қарманынаң	сущ.	
қарманынға	сущ.	
қарчыйлан	дееприч.	
қарчыйланып	дееприч.	
қарыш	сущ.	
қастағын	сущ.	
қачен	мест.	
қачырыбыза	дееприч.	
қачырыбысқаны	прич.	
қачырыбысты	глаг.	
қодурбас	дееприч.	
қожанчыба	сущ.	
қолтуқтан	дееприч.	
қолуба	сущ.	
қолумға	сущ.	
қолумнаң	сущ.	
қолун	сущ.	
қолуна	сущ.	
қолунаң	сущ.	
қолунға	сущ.	
қонужу	сущ.	
қор	масть коня, прил.	
қоруғуп	дееприч.	
қоруқпаан	прич.	
қоруқчаң	прич.	
қоштаныш	дееприч.	
қуба	прил., но тж часть имени собств.	
қуйағын	сущ.	
қулат	масть коня вместе со словом конь	
қулатай	имя собств.	
қулаттың	сущ. (масть коня, родит.пад.)	
қумыс-аш	сущ.	
қуртйақ	сущ.	
қуруг	прил.	
қучақтан	дееприч.	
қучақтанып	дееприч.	
қушту	сущ.	
қуштуң	сущ.	
қыдай	часть имени собств.	
қыйғанақ	часть имени собств.	
қыйғылашчалар	глаг.	
қыйғылық	сущ.	
қылған	сущ.	
қылғанап	формально - дееприч.	
қылыжын	сущ., но м.б. и часть имени собств.	
қынат	прил.	
қыпчып	нареч.	
қырбан	сущ.	
қысйақ	сущ.	
қысқырыш	сущ., но м.б. и дееприч.	
қыш	сущ.	
ла	частица	
ле	частица	
леш	имя собств., русск. Алексей? Леха?	
леш-тайым	имя собств.	
ма	частица	
маа	мест.	
малын	сущ.	
маңыс	часть имени собств.	
маңыстың	часть имени собств.	
марстар	сущ., м.б. часть имени собств.	
мас	сущ., м.б. часть имени собств.	
маттап	нареч.	
мендиг	мест.	
мең	сущ.	
мерет	часть имени собств.	
мӧгӧ	часть имени собств.	
мойдунға	сущ.	
моңус	часть имени собств., но м.б. и прилаг.	
моңустың	то же самое	
мӱндӱ	???	
мӱӱстӱг	прил.	
на	частица	
нана-нана	дееприч.	
нанды	глаг.	
нанынға	сущ., нареч. (набок, на сторону, но тж в его сторону)	
нара	дееприч.	
не	частица	
нигилишча	глаг.	
нигилча	глаг.	
но	мест.	
нырслақ	сущ.	
уғжап	уғжа- мять, сминать (но это можно писать и как уужа-п)	
уғжап-ташқап	что-то типа сминая-сжимая, но точное значение слова ташка- я не знаю	
уғлалыг	уғла-лыг имеющий углы, с углами	
уғлучақ	углу-чак маль-чик, сыно-чек	
ӱдӱре	напротив	
ӱжеле	втроем	
ужу	если как существительное, то тогда это 'конец' (вариант ужы)	
ужунға	на край чего-то	
ужунда	на краю чего-то	
ужуп	уш-у-п 'летя' Не уверен, но это м.б. и лично таннагашевское ужуп пар-, словаре же можно найти учук пар- (от глаг учук- летать)	
узун	длинный	
уйазынаң	уйа-зы-наң от своего гнезда	
уққан-кӧрген	слышал-видел	
улуг-кичиг	большой и малый	
улуғ	надо писать улуг	
улыг	улыг=улуг	
улыг-кичиг	улыг-кичиг = улуг-кичиг большой и малый	
ӱнӱ	голос (его)	
ур	долго	
ӱргӱн	радоваться, веселиться	
успачы	успачы=уста=усчы=ус мастер, кузнец	
усталға	на стол	
устол	устол=устал	
ӱстӱ	верх	
ӱстӱбе	поверху	
устуқ	бедро	
ӱстӱнге	наверх	
ӱстӱнгизи	верхний, вверху находящийся	
ӱстӱнде	наверху	
ӱстӱнең	сверху	
ӱчин	ӱчин=ӱчӱн 'ради' (послелог)	
ӱшкӱр	ӱшкӱр- взыхать	
ушқаш	ушкаш=ошкош словно (послелог)	
чабал	плохой	
чаға-тӧштең	ворот-грудь-исх.пад.	
чағыннарынға	чагын-нар-ын-га что-то вроде 'своим близким'	
чағыс	одинокий	
чағысқа	одинокий дат.пад.	
чағыш	надо смотреть, что за форма	
чажы	чаш-ы его возраст или его слезы	
чазаг	пеший, пешком	
чазыда	на поле, во степи	
чазышча	час-ы-ш-ча убегает (скорее всего, речь о многих субьектах, но оформлена афф.ед.ч., то етсь убегают, разбегаются	
чайалардоқ	чайа-лар-ды-ок	
чайан-пурқан	имя собств.	
чайқап	чайка-п качая, кивая	
чайқыл	качаясь (скорее всего, это о воде: качаясь, волнуясь)	
чалбақ	широкий	
чалтырап	прич. от чалт(ы)ра- блестеть, сверкать	
чалын	пламя	
чанынға	в сторону (от чего-то)	
чанында	на стороне от чего-то	
чапан	кусок от имени собств. (Чабыс-Чапан)	
чапшынды	чапшын-ды приклеился, прилепился	
чапшындылар	чапшын-ды-лар	
чапшырып	чапшыр-ы-п причастие от глаг чапшыр- клеить	
чардық	половина	
че	типа "да", согласие, одобрение, но может быть и афф.сравнит.-предельного падежа, но в этом случае его надо писать слотно со словом	
чеген	вообще-то то один из вариантов айрана, но в эпосе :) это Вселенная	
чегрен	рыжий (масть коня)	
чедеге	чет-е(р)ге инфинитив (или супин) от глаг чет- достигать, догонять	
чединип	чет-и-н-и-п прич. от глаг. Чет-	
чеек-перген	имя собств.	
чексеген	чексе- скучать	
челтек	чёлка'	
чеппе	кусок от имени собств. (Чеппе-Салгын)	
чер-суг	родина, своя земля, букв. Земля-вода	
черген	скорее всего, это вариант слова чегрен	
черин	чер-и-н	
черинге	чер-и-н-ге	
черинде	чер-и-н-де	
черине	чер-и-н-(г)е	
черинең	чер-и-нен	
четпезе	чет-пе-зе если он не достигнет, не убьет и т.п.	
четсе	чет-се если он достигнет (слов чет- многозначно, напр., о дани тоже можно сказать чет- 'сдавать')	
чи	см у Чиспиякова в самом конце	
чибек	шелковая нитка	
чибекти	чибек-ти	
чидилер	чи-ди-лер от глаг. Чи- (в словаре чаще пишут чии-)	
читкен	прОклятый, проклЯтый :)	
чӧбоқ		
чоғул	нет	 формально это должно быть аналогом турецкого дейиль - отрицание свойства, но я проверял по Корпусу: в шорском разницы между чок и чогул не видно
чолуба	чол-у-ба = чол-ы-ба по его дороге, по его следу	
чонну	чон-ну = чон-ны вин.пад.	
чонын		
чӧӧк	вопр.слово почему?	
чортушпа	медленно, рысью, рысцой	
чӱгӱрӱбискени		
чӱгӱрӱбисти	чӱгӱр-ӱ-п-ис-ти он быстро убежал, ускакал	
чуртуна	чурт-у-н-(ғ)а	
чӱче	вар-т чӱтче 'немного'	
чығылышчалар	чыгыл-ы-ш-ча-лар падают, валятся (они вместе)	
чылаш	голый	
шабыза	шап-ыс-а ударяя	
шабылып	ударяясь	
шағанаң	что-то типа межд. 'как' указывает на быстроту, внезапность действия	
шала	немного, чуть	
шамдар	игрений	
шамдарды	игренего в.п.	
шачыл	шачыл- прыгнуть, скакнуть	
шачылған	шачыл-ган скакнувший	
шер	не помню????	
шеш	шеш- развязывать	
ширкеге	ширке-ге на постель, на кровать	
шойын	сущ. Это чугун	
шыға-шыға	выходя-выходя Посмотри у дыренкой или Чиспиякова: там есть хар-ка подобных форм	
шығыбыстылар	шык-ы-п-ыс-ты-лар они быстро вышли	
шығыжы	отглаг.существит. Шык- выходить	
шықчат	шык-чат=шык-ча выходит	
ылғапчадыр	ылга-п-чадыр = ылга-п-ча он плачет	
эбине	эп 'дом' (уже не помню, какой это диалект)	
эгбенинге	эгбен плечо	
эдегин	эдек подол (платья, напр.)	
эжигин	эжик дверь, порог	
эзен-менчи	просто формула приветствия	
эзенин	обычно в формуле: эзенин пер- 'давать здравствие', здороваться	
эзерин	им.пад. Эзер седло	
эккей	межд. типа Эй, эгей, послушай, вот …	
эқсийин	вин.пад. от эқси 'рот', но и экси само по себе является некой притяжат.формой от им.пад., который вообще употребляется	
эр-қулатай	имя собственное	
эрбектен	наверняка это сокращенная форма причастия эрбектенип	
эрбектенди	см. ниже: это прош.вр. 3 л.ед.ч. Эрбекте-н-ди	
эрбектенча	эрбекте-н-ча он/а говорит, разговаривает (надо смотреть контекст, но вообще -н- это что-то, направленное внутрь, т.е. типа говорит сам с собою)	
эртегени	надо смотреть, но это точно от глагола эрт- обходить, проходить	
эртен	утром	
эртипча	эрт-и-п-ча он проходит, обходит	
эртишча	то же самое, только здесь -ш- которое указывает на совместность действия	
ээдоқ	ээде оқ	
